GEOID,county,tract,ma_lf_b12,un_w16-50_b12_lf,total_lf_b12
06067008702,067,008702,9,0,9
06067008905,067,008905,14,0,14
06067008908,067,008908,40,0,40
06067008910,067,008910,10,77,87
06067000200,067,000200,50,0,50
06067000400,067,000400,16,0,16
06067004202,067,004202,31,57,88
06067004203,067,004203,10,41,51
06067004300,067,004300,12,14,26
06067005202,067,005202,41,0,41
06067005505,067,005505,0,28,28
06037482702,037,482702,28,0,28
06037500201,037,500201,0,0,0
06037500202,037,500202,0,14,14
06037532304,037,532304,0,7,7
06037532606,037,532606,8,30,38
06037532800,037,532800,5,29,34
06037532900,037,532900,0,68,68
06037603102,037,603102,45,0,45
06037551700,037,551700,10,51,61
06037552100,037,552100,26,13,39
06037552601,037,552601,46,63,109
06001401500,001,401500,4,12,16
06001401700,001,401700,16,11,27
06001402200,001,402200,5,18,23
06037403802,037,403802,39,42,81
06037404901,037,404901,38,11,49
06037405500,037,405500,33,89,122
06037408401,037,408401,12,0,12
06037408402,037,408402,30,25,55
06037430600,037,430600,14,9,23
06037431200,037,431200,27,17,44
06037432402,037,432402,0,0,0
06037124203,037,124203,11,0,11
06037124204,037,124204,13,0,13
06037124902,037,124902,9,0,9
06037124903,037,124903,0,8,8
06037125401,037,125401,47,0,47
06037125402,037,125402,27,10,37
06037125501,037,125501,23,0,23
06037125502,037,125502,0,0,0
06037127103,037,127103,38,18,56
06037127104,037,127104,7,0,7
06037127603,037,127603,38,0,38
06037127604,037,127604,27,0,27
06037127605,037,127605,43,11,54
06037127711,037,127711,0,22,22
06037127606,037,127606,46,0,46
06037127712,037,127712,0,0,0
06037127803,037,127803,31,0,31
06037127804,037,127804,8,0,8
06037127805,037,127805,0,11,11
06037127806,037,127806,18,10,28
06037128101,037,128101,24,21,45
06037980013,037,980013,0,0,0
06037980014,037,980014,0,0,0
06037980015,037,980015,0,0,0
06037980018,037,980018,0,0,0
06037980019,037,980019,0,0,0
06037980020,037,980020,0,0,0
06037980021,037,980021,0,0,0
06037980022,037,980022,0,0,0
06037980023,037,980023,0,0,0
06037980025,037,980025,0,0,0
06037980030,037,980030,0,0,0
06037980031,037,980031,0,0,0
06037980033,037,980033,0,0,0
06037980026,037,980026,0,0,0
06037141101,037,141101,16,0,16
06037141102,037,141102,10,0,10
06037141201,037,141201,0,34,34
06037141202,037,141202,7,8,15
06037141303,037,141303,0,0,0
06037531101,037,531101,0,0,0
06037277400,037,277400,2,0,2
06037291300,037,291300,7,0,7
06037294120,037,294120,16,7,23
06037294520,037,294520,9,20,29
06037294820,037,294820,4,26,30
06037296220,037,296220,13,0,13
06037297300,037,297300,0,0,0
06037300600,037,300600,43,0,43
06037300901,037,300901,0,0,0
06037301100,037,301100,14,43,57
06037302202,037,302202,27,0,27
06037302302,037,302302,15,40,55
06037311300,037,311300,17,0,17
06037320000,037,320000,0,0,0
06037400604,037,400604,50,0,50
06037401203,037,401203,40,32,72
06037401500,037,401500,9,48,57
06037401602,037,401602,11,8,19
06037101110,037,101110,11,0,11
06037103200,037,103200,0,44,44
06037104103,037,104103,0,0,0
06037106603,037,106603,21,0,21
06037108102,037,108102,11,0,11
06037109601,037,109601,28,0,28
06037109700,037,109700,16,0,16
06037111201,037,111201,88,9,97
06037113232,037,113232,30,0,30
06037113422,037,113422,0,21,21
06085505006,085,505006,101,0,101
06085505700,085,505700,70,0,70
06085506103,085,506103,50,0,50
06085506202,085,506202,73,0,73
06085506301,085,506301,36,0,36
06085506302,085,506302,83,0,83
06085506304,085,506304,0,0,0
06085503304,085,503304,63,13,76
06085502906,085,502906,55,0,55
06085503001,085,503001,44,0,44
06085503108,085,503108,22,87,109
06085503312,085,503312,25,33,58
06085503402,085,503402,9,41,50
06085503506,085,503506,53,14,67
06059062604,059,062604,124,0,124
06059062629,059,062629,0,0,0
06059062640,059,062640,17,0,17
06065040402,065,040402,16,0,16
06065040501,065,040501,34,0,34
06065042514,065,042514,13,0,13
06065042404,065,042404,0,0,0
06065042505,065,042505,5,7,12
06065042510,065,042510,10,0,10
06065042518,065,042518,34,39,73
06065042519,065,042519,29,0,29
06065042720,065,042720,54,10,64
06065043006,065,043006,29,27,56
06065043314,065,043314,9,0,9
06085512509,085,512509,32,0,32
06085512510,085,512510,20,54,74
06085512603,085,512603,0,5,5
06085512604,085,512604,40,14,54
06085513000,085,513000,16,20,36
06085513500,085,513500,0,0,0
06037434004,037,434004,12,0,12
06037461501,037,461501,7,0,7
06037460401,037,460401,15,11,26
06037910205,037,910205,0,0,0
06037910302,037,910302,63,0,63
06037920020,037,920020,0,13,13
06037920015,037,920015,17,24,41
06001436900,001,436900,23,9,32
06001437000,001,437000,17,0,17
06001438300,001,438300,33,32,65
06001440304,001,440304,7,0,7
06001441402,001,441402,35,0,35
06001441522,001,441522,36,0,36
06001441800,001,441800,27,0,27
06001441921,001,441921,75,0,75
06001442000,001,442000,18,0,18
06001442100,001,442100,18,0,18
06001442200,001,442200,11,0,11
06001440331,001,440331,9,8,17
06001441302,001,441302,94,10,104
06067009310,067,009310,73,54,127
06067009318,067,009318,19,0,19
06067009610,067,009610,56,56,112
06067009611,067,009611,8,0,8
06067009614,067,009614,68,9,77
06067009004,067,009004,9,0,9
06067009103,067,009103,0,0,0
06067009106,067,009106,8,0,8
06065941200,065,941200,3,0,3
06065941300,065,941300,8,0,8
06065941400,065,941400,11,7,18
06065941500,065,941500,22,49,71
06065980004,065,980004,0,0,0
06065981000,065,981000,0,0,0
06067001101,067,001101,0,29,29
06067003204,067,003204,25,21,46
06067004501,067,004501,11,6,17
06001443301,001,443301,0,0,0
06001450742,001,450742,21,36,57
06001451601,001,451601,14,0,14
06001451701,001,451701,59,12,71
06001400600,001,400600,26,5,31
06001401200,001,401200,9,0,9
06001403100,001,403100,15,6,21
06001403800,001,403800,24,0,24
06001404000,001,404000,23,0,23
06001404501,001,404501,12,0,12
06001405100,001,405100,109,0,109
06001405700,001,405700,0,0,0
06001405800,001,405800,0,0,0
06001406900,001,406900,17,0,17
06001436602,001,436602,14,14,28
06001433300,001,433300,89,0,89
06001435300,001,435300,0,0,0
06001436300,001,436300,15,20,35
06001437300,001,437300,49,16,65
06001437500,001,437500,8,15,23
06001437800,001,437800,36,0,36
06001438100,001,438100,75,60,135
06085512036,085,512036,14,11,25
06085512037,085,512037,27,0,27
06085512039,085,512039,64,0,64
06085512038,085,512038,39,0,39
06085512042,085,512042,21,27,48
06085512043,085,512043,65,16,81
06085512045,085,512045,35,0,35
06085512047,085,512047,29,7,36
06073021204,073,021204,53,0,53
06073021302,073,021302,8,8,16
06073021304,073,021304,0,0,0
06073019403,073,019403,15,8,23
06073019503,073,019503,94,30,124
06073019702,073,019702,7,0,7
06037232800,037,232800,9,42,51
06037234600,037,234600,0,41,41
06037237900,037,237900,0,53,53
06085503217,085,503217,28,0,28
06085503323,085,503323,30,0,30
06085503324,085,503324,34,0,34
06085503325,085,503325,0,0,0
06085504001,085,504001,28,0,28
06085504201,085,504201,77,0,77
06085504318,085,504318,34,9,43
06085504411,085,504411,46,8,54
06085504418,085,504418,4,8,12
06037920313,037,920313,39,9,48
06037920334,037,920334,27,0,27
06037103101,037,103101,71,0,71
06037104201,037,104201,48,6,54
06037104320,037,104320,21,0,21
06037104620,037,104620,23,44,67
06037104701,037,104701,11,42,53
06037104810,037,104810,62,0,62
06037106112,037,106112,44,32,76
06037106113,037,106113,28,0,28
06037267501,037,267501,21,0,21
06037920031,037,920031,35,0,35
06037910401,037,910401,110,21,131
06037910804,037,910804,13,0,13
06037920018,037,920018,6,0,6
06037601202,037,601202,41,16,57
06037601802,037,601802,28,8,36
06037601900,037,601900,74,0,74
06037602302,037,602302,80,0,80
06073008339,073,008339,3,0,3
06073008347,073,008347,104,17,121
06073008354,073,008354,87,0,87
06073008505,073,008505,67,14,81
06073017604,073,017604,51,33,84
06073018400,073,018400,9,0,9
06073015501,073,015501,49,0,49
06073015703,073,015703,0,0,0
06073015801,073,015801,20,54,74
06073015802,073,015802,11,8,19
06073015901,073,015901,0,66,66
06073016000,073,016000,9,20,29
06073016201,073,016201,55,12,67
06073016610,073,016610,37,8,45
06073016614,073,016614,11,0,11
06073016615,073,016615,19,0,19
06073016702,073,016702,17,0,17
06073017022,073,017022,6,0,6
06073017108,073,017108,35,0,35
06073017305,073,017305,50,0,50
06073017811,073,017811,20,0,20
06073018511,073,018511,47,73,120
06073018514,073,018514,0,26,26
06073018516,073,018516,10,0,10
06073018601,073,018601,39,0,39
06073018609,073,018609,0,0,0
06073018801,073,018801,0,0,0
06037602402,037,602402,23,0,23
06037701502,037,701502,20,0,20
06037543601,037,543601,28,0,28
06059075202,059,075202,12,11,23
06059075301,059,075301,38,0,38
06059032032,059,032032,11,0,11
06059032035,059,032035,3,0,3
06059032038,059,032038,38,0,38
06059032050,059,032050,29,29,58
06059042111,059,042111,0,0,0
06059042317,059,042317,12,0,12
06059042320,059,042320,98,0,98
06059042325,059,042325,18,18,36
06059052408,059,052408,20,25,45
06059001202,059,001202,10,0,10
06059001504,059,001504,81,0,81
06059011102,059,011102,12,0,12
06059063007,059,063007,20,0,20
06059074405,059,074405,2,10,12
06059074406,059,074406,0,10,10
06073018905,073,018905,0,12,12
06073019602,073,019602,33,0,33
06073019902,073,019902,17,17,34
06073019905,073,019905,22,12,34
06073020013,073,020013,78,0,78
06073020016,073,020016,89,0,89
06073020211,073,020211,29,23,52
06073020304,073,020304,70,18,88
06073020307,073,020307,86,17,103
06073020601,073,020601,14,8,22
06073001100,073,001100,73,0,73
06073001700,073,001700,28,0,28
06073001800,073,001800,13,20,33
06073001900,073,001900,10,0,10
06073002100,073,002100,0,19,19
06073002401,073,002401,10,0,10
06073002708,073,002708,72,0,72
06073002709,073,002709,8,0,8
06073002803,073,002803,31,20,51
06073002902,073,002902,49,0,49
06073003115,073,003115,39,30,69
06073003202,073,003202,6,8,14
06073003502,073,003502,11,20,31
06073003602,073,003602,0,35,35
06073004100,073,004100,0,0,0
06073005100,073,005100,17,0,17
06073006100,073,006100,53,0,53
06073007100,073,007100,0,0,0
06073007302,073,007302,4,0,4
06073008102,073,008102,17,0,17
06073008333,073,008333,139,0,139
06037134720,037,134720,0,6,6
06037137201,037,137201,100,0,100
06037137502,037,137502,63,0,63
06037137504,037,137504,4,0,4
06037139702,037,139702,0,0,0
06037143500,037,143500,15,56,71
06037181400,037,181400,19,0,19
06037189400,037,189400,14,8,22
06037185202,037,185202,0,0,0
06037188300,037,188300,97,0,97
06037189902,037,189902,14,10,24
06037190100,037,190100,49,0,49
06037192300,037,192300,25,0,25
06037195100,037,195100,7,0,7
06037195720,037,195720,6,18,24
06037199201,037,199201,0,20,20
06037203200,037,203200,33,18,51
06037203800,037,203800,24,13,37
06037204700,037,204700,36,23,59
06073015301,073,015301,24,0,24
06073015405,073,015405,0,22,22
06073015602,073,015602,7,0,7
06073015704,073,015704,46,15,61
06073016100,073,016100,41,164,205
06073016301,073,016301,66,19,85
06073016605,073,016605,35,0,35
06073016606,073,016606,44,0,44
06073016607,073,016607,0,0,0
06073016612,073,016612,0,12,12
06073016802,073,016802,0,18,18
06073016806,073,016806,0,0,0
06073017030,073,017030,191,0,191
06073017031,073,017031,6,9,15
06073017042,073,017042,38,0,38
06073017044,073,017044,87,0,87
06073017045,073,017045,18,0,18
06073018700,073,018700,406,59,465
06073018803,073,018803,44,0,44
06073019106,073,019106,24,2,26
06073019601,073,019601,0,9,9
06073008200,073,008200,29,0,29
06073008301,073,008301,0,0,0
06073008305,073,008305,18,0,18
06073008307,073,008307,12,0,12
06073008324,073,008324,14,0,14
06073013503,073,013503,0,110,110
06073013506,073,013506,11,37,48
06073013702,073,013702,35,0,35
06073014002,073,014002,0,0,0
06073014101,073,014101,0,0,0
06073014804,073,014804,15,0,15
06073019904,073,019904,9,17,26
06067006900,067,006900,18,23,41
06067008137,067,008137,0,0,0
06067008210,067,008210,0,0,0
06067008404,067,008404,7,22,29
06037480201,037,480201,28,0,28
06037480901,037,480901,0,0,0
06037481300,037,481300,0,11,11
06037481603,037,481603,7,9,16
06037481714,037,481714,16,0,16
06037482301,037,482301,75,0,75
06037482401,037,482401,27,0,27
06037482600,037,482600,15,0,15
06037552900,037,552900,28,38,66
06037553100,037,553100,27,0,27
06037553701,037,553701,0,33,33
06037553901,037,553901,19,44,63
06037554516,037,554516,11,0,11
06037555104,037,555104,48,4,52
06037570002,037,570002,23,10,33
06037570204,037,570204,0,82,82
06037572002,037,572002,70,50,120
06037572201,037,572201,7,0,7
06037573402,037,573402,53,0,53
06037574100,037,574100,44,13,57
06037574400,037,574400,59,0,59
06037143602,037,143602,0,0,0
06037139303,037,139303,77,0,77
06037139600,037,139600,0,0,0
06037139701,037,139701,5,0,5
06037183101,037,183101,16,18,34
06037185310,037,185310,0,13,13
06037186401,037,186401,5,23,28
06037189701,037,189701,0,0,0
06037190700,037,190700,0,0,0
06037190902,037,190902,0,0,0
06037191110,037,191110,8,0,8
06037191500,037,191500,10,33,43
06037192410,037,192410,0,0,0
06037192420,037,192420,9,0,9
06037540700,037,540700,0,19,19
06037404702,037,404702,5,0,5
06037403721,037,403721,7,25,32
06037403901,037,403901,5,6,11
06037404100,037,404100,25,82,107
06037404802,037,404802,34,0,34
06037405001,037,405001,22,24,46
06037406601,037,406601,34,13,47
06001451503,001,451503,55,0,55
06001409300,001,409300,16,0,16
06001409700,001,409700,34,0,34
06001451300,001,451300,79,0,79
06001402400,001,402400,0,40,40
06001404300,001,404300,53,27,80
06001404800,001,404800,26,0,26
06001406202,001,406202,0,40,40
06001406400,001,406400,10,8,18
06073020207,073,020207,32,57,89
06073020706,073,020706,47,33,80
06073020806,073,020806,48,0,48
06073020902,073,020902,0,11,11
06073020904,073,020904,0,0,0
06073008327,073,008327,29,0,29
06073008502,073,008502,0,25,25
06073008507,073,008507,96,0,96
06067007416,067,007416,7,0,7
06067007503,067,007503,12,0,12
06067007702,067,007702,26,10,36
06067008111,067,008111,18,0,18
06067008117,067,008117,0,5,5
06067008130,067,008130,14,25,39
06067008133,067,008133,10,13,23
06073018906,073,018906,16,19,35
06073019002,073,019002,3,16,19
06073019205,073,019205,58,0,58
06073020019,073,020019,20,0,20
06073020305,073,020305,80,58,138
06073020707,073,020707,19,24,43
06073020807,073,020807,10,0,10
06073021100,073,021100,4,0,4
06073021303,073,021303,51,0,51
06073008303,073,008303,27,0,27
06073008306,073,008306,0,0,0
06073008310,073,008310,16,0,16
06073008329,073,008329,90,89,179
06073008340,073,008340,265,0,265
06073008341,073,008341,39,0,39
06073008350,073,008350,61,0,61
06073008358,073,008358,80,0,80
06037980028,037,980028,0,0,0
06037990100,037,990100,0,0,0
06037990300,037,990300,0,0,0
06037990200,037,990200,0,0,0
06085503508,085,503508,13,0,13
06059032051,059,032051,0,15,15
06067009107,067,009107,51,0,51
06067009403,067,009403,0,0,0
06067001400,067,001400,0,0,0
06067002600,067,002600,0,0,0
06067002700,067,002700,25,9,34
06067003800,067,003800,18,17,35
06067004001,067,004001,22,0,22
06067004100,067,004100,22,50,72
06067004601,067,004601,0,0,0
06067004802,067,004802,8,11,19
06067004904,067,004904,0,5,5
06067005502,067,005502,19,0,19
06067005701,067,005701,15,0,15
06067008206,067,008206,88,0,88
06071002804,071,002804,20,58,78
06071003101,071,003101,31,26,57
06071003102,071,003102,20,39,59
06071003302,071,003302,0,39,39
06071003404,071,003404,0,80,80
06071003405,071,003405,16,36,52
06071003503,071,003503,23,18,41
06071003505,071,003505,43,65,108
06071003506,071,003506,47,0,47
06071003507,071,003507,0,61,61
06071003509,071,003509,0,45,45
06071003510,071,003510,11,25,36
06071003603,071,003603,6,13,19
06071003605,071,003605,22,54,76
06071003606,071,003606,42,26,68
06037554522,037,554522,0,0,0
06037554600,037,554600,0,17,17
06037570001,037,570001,51,12,63
06037572202,037,572202,9,0,9
06037572600,037,572600,18,10,28
06037573002,037,573002,2,10,12
06037574202,037,574202,6,5,11
06037575001,037,575001,48,7,55
06037575801,037,575801,10,0,10
06037577400,037,577400,43,0,43
06037599100,037,599100,0,0,0
06037600902,037,600902,0,71,71
06037601100,037,601100,27,53,80
06037603500,037,603500,6,0,6
06085504806,085,504806,38,0,38
06085506401,085,506401,0,14,14
06085506501,085,506501,126,0,126
06085503321,085,503321,30,0,30
06085503327,085,503327,21,24,45
06085503510,085,503510,32,0,32
06085501200,085,501200,37,0,37
06085501700,085,501700,29,0,29
06085502201,085,502201,45,0,45
06001437600,001,437600,13,11,24
06001440301,001,440301,40,0,40
06001407700,001,407700,46,0,46
06001420400,001,420400,58,0,58
06001428200,001,428200,52,0,52
06001441100,001,441100,0,0,0
06001441602,001,441602,0,0,0
06001451501,001,451501,9,0,9
06001403600,001,403600,0,0,0
06001405000,001,405000,65,0,65
06085503329,085,503329,40,0,40
06085503330,085,503330,0,0,0
06085503331,085,503331,0,0,0
06085503332,085,503332,43,0,43
06085503322,085,503322,13,9,22
06085512200,085,512200,9,0,9
06085506601,085,506601,50,25,75
06085506701,085,506701,33,0,33
06085506702,085,506702,22,39,61
06085506803,085,506803,0,0,0
06085507401,085,507401,11,0,11
06085508602,085,508602,14,0,14
06085508703,085,508703,60,0,60
06085508800,085,508800,33,0,33
06085508900,085,508900,56,0,56
06085509000,085,509000,56,93,149
06085509107,085,509107,20,0,20
06085509303,085,509303,6,0,6
06085510100,085,510100,0,0,0
06085511910,085,511910,0,0,0
06085511911,085,511911,11,0,11
06085512505,085,512505,130,0,130
06071006100,071,006100,122,124,246
06071006700,071,006700,0,0,0
06071007107,071,007107,0,14,14
06071007108,071,007108,6,17,23
06071007408,071,007408,40,81,121
06071000111,071,000111,24,0,24
06071000303,071,000303,21,14,35
06071000812,071,000812,15,0,15
06071002010,071,002010,75,0,75
06037264102,037,264102,0,6,6
06037264103,037,264103,12,0,12
06037265201,037,265201,0,0,0
06037265202,037,265202,30,0,30
06037265601,037,265601,22,0,22
06037267403,037,267403,50,0,50
06037204810,037,204810,21,7,28
06037216100,037,216100,27,13,40
06037216700,037,216700,10,0,10
06037600704,037,600704,43,0,43
06037601001,037,601001,32,0,32
06037601211,037,601211,24,19,43
06037601501,037,601501,0,0,0
06037601801,037,601801,0,28,28
06037602002,037,602002,27,22,49
06037602105,037,602105,21,0,21
06037620400,037,620400,0,0,0
06037650901,037,650901,85,53,138
06037651222,037,651222,56,0,56
06037670100,037,670100,39,71,110
06071009712,071,009712,0,15,15
06071009717,071,009717,18,0,18
06073019301,073,019301,112,13,125
06073019502,073,019502,44,25,69
06073020014,073,020014,109,0,109
06073020107,073,020107,42,0,42
06065041804,065,041804,13,0,13
06065041806,065,041806,42,0,42
06065042005,065,042005,24,0,24
06065042512,065,042512,29,0,29
06065042507,065,042507,0,0,0
06065042509,065,042509,0,0,0
06065042513,065,042513,2,44,46
06065042520,065,042520,5,0,5
06065042521,065,042521,12,32,44
06065042714,065,042714,0,0,0
06065042719,065,042719,22,21,43
06065042800,065,042800,51,37,88
06065043211,065,043211,39,32,71
06065043218,065,043218,18,0,18
06065043220,065,043220,38,43,81
06065043503,065,043503,12,36,48
06037111100,037,111100,13,0,13
06037111302,037,111302,0,0,0
06037111400,037,111400,0,0,0
06001440200,001,440200,22,0,22
06001440308,001,440308,31,0,31
06001441501,001,441501,43,13,56
06001442500,001,442500,87,0,87
06001450300,001,450300,44,0,44
06001450607,001,450607,0,15,15
06001404700,001,404700,38,0,38
06001404900,001,404900,20,0,20
06001405200,001,405200,13,0,13
06001406300,001,406300,18,0,18
06001400100,001,400100,29,0,29
06001400800,001,400800,25,0,25
06001401000,001,401000,18,0,18
06037500300,037,500300,32,0,32
06073009301,073,009301,24,0,24
06073009507,073,009507,35,24,59
06073009603,073,009603,21,0,21
06073009804,073,009804,20,0,20
06073010009,073,010009,51,57,108
06073010107,073,010107,68,12,80
06073013000,073,013000,64,0,64
06073013312,073,013312,14,8,22
06073013313,073,013313,106,29,135
06073013411,073,013411,46,0,46
06073015100,073,015100,21,0,21
06073015403,073,015403,21,0,21
06037408626,037,408626,45,0,45
06037431800,037,431800,29,0,29
06037460302,037,460302,57,12,69
06037463700,037,463700,0,0,0
06059001401,059,001401,19,31,50
06059001506,059,001506,34,17,51
06059001708,059,001708,0,0,0
06059001903,059,001903,4,8,12
06037570402,037,570402,35,11,46
06037572001,037,572001,66,0,66
06037407101,037,407101,45,0,45
06037400402,037,400402,21,9,30
06037402402,037,402402,15,30,45
06037405102,037,405102,11,0,11
06037430002,037,430002,35,0,35
06037431600,037,431600,0,0,0
06037117510,037,117510,16,13,29
06037134422,037,134422,28,0,28
06037141700,037,141700,0,0,0
06037131010,037,131010,38,56,94
06037920110,037,920110,0,0,0
06037574601,037,574601,0,0,0
06037577501,037,577501,30,0,30
06037407302,037,407302,40,34,74
06037408501,037,408501,14,0,14
06071003607,071,003607,0,15,15
06071003609,071,003609,36,17,53
06071003611,071,003611,21,20,41
06071003612,071,003612,0,0,0
06071003801,071,003801,17,24,41
06071003803,071,003803,32,40,72
06071003804,071,003804,0,74,74
06071004001,071,004001,8,9,17
06071004003,071,004003,43,28,71
06071004004,071,004004,55,5,60
06071004101,071,004101,22,31,53
06071004103,071,004103,0,23,23
06071004104,071,004104,80,95,175
06037294810,037,294810,26,11,37
06037300701,037,300701,0,0,0
06037301502,037,301502,0,0,0
06037301601,037,301601,0,0,0
06037302102,037,302102,64,0,64
06037143902,037,143902,25,0,25
06037183620,037,183620,22,25,47
06037187300,037,187300,13,0,13
06037189702,037,189702,9,0,9
06037199110,037,199110,0,28,28
06037191720,037,191720,0,0,0
06037197200,037,197200,23,43,66
06037199900,037,199900,0,11,11
06037650101,037,650101,78,0,78
06037574800,037,574800,0,0,0
06037574902,037,574902,25,0,25
06037575103,037,575103,5,52,57
06037575902,037,575902,14,30,44
06037576401,037,576401,9,0,9
06037600202,037,600202,9,36,45
06037600400,037,600400,0,9,9
06037600602,037,600602,10,14,24
06037601600,037,601600,20,0,20
06037601700,037,601700,0,9,9
06037602200,037,602200,66,16,82
06037603101,037,603101,13,8,21
06037603400,037,603400,81,0,81
06037620001,037,620001,30,0,30
06037620002,037,620002,34,0,34
06037620201,037,620201,23,0,23
06037603704,037,603704,94,18,112
06037603900,037,603900,18,11,29
06037620901,037,620901,6,6,12
06067008136,067,008136,11,0,11
06067000600,067,000600,0,0,0
06067000700,067,000700,0,0,0
06067001800,067,001800,0,0,0
06067002200,067,002200,24,74,98
06067002900,067,002900,79,0,79
06067003000,067,003000,16,0,16
06067003900,067,003900,17,0,17
06067004012,067,004012,9,0,9
06067004905,067,004905,12,29,41
06067007904,067,007904,0,8,8
06067008138,067,008138,8,0,8
06067008211,067,008211,0,0,0
06067009309,067,009309,5,0,5
06067008208,067,008208,12,16,28
06067008504,067,008504,13,9,22
06067008600,067,008600,0,0,0
06067009008,067,009008,0,0,0
06067009307,067,009307,29,0,29
06067009406,067,009406,0,0,0
06067009502,067,009502,83,74,157
06067000300,067,000300,48,1,49
06067000500,067,000500,0,12,12
06067000800,067,000800,0,0,0
06067001300,067,001300,19,22,41
06067002100,067,002100,0,21,21
06067003101,067,003101,0,13,13
06067000100,067,000100,50,0,50
06001400400,001,400400,48,0,48
06001403300,001,403300,0,0,0
06001401300,001,401300,0,0,0
06001408800,001,408800,23,38,61
06001403000,001,403000,0,0,0
06037571502,037,571502,7,44,51
06037571600,037,571600,0,20,20
06037573202,037,573202,20,0,20
06037573902,037,573902,0,0,0
06037576403,037,576403,28,29,57
06037576501,037,576501,11,37,48
06037221220,037,221220,0,0,0
06037221820,037,221820,0,0,0
06037224010,037,224010,0,0,0
06037224600,037,224600,0,26,26
06037267404,037,267404,24,0,24
06037265602,037,265602,22,0,22
06037267901,037,267901,10,0,10
06037269602,037,269602,16,0,16
06037267902,037,267902,45,0,45
06037269601,037,269601,17,0,17
06037269903,037,269903,0,0,0
06037269904,037,269904,14,0,14
06037227010,037,227010,0,11,11
06037228310,037,228310,0,48,48
06037228800,037,228800,0,25,25
06037229410,037,229410,22,18,40
06037231900,037,231900,0,0,0
06037232120,037,232120,12,48,60
06085512602,085,512602,0,19,19
06085506804,085,506804,62,0,62
06085507301,085,507301,10,0,10
06085507903,085,507903,7,0,7
06085507906,085,507906,13,0,13
06085508102,085,508102,21,0,21
06085508401,085,508401,0,1,1
06085508403,085,508403,23,0,23
06085508503,085,508503,29,0,29
06085508601,085,508601,28,0,28
06085509102,085,509102,17,0,17
06085509105,085,509105,112,0,112
06085509201,085,509201,36,0,36
06085510002,085,510002,32,8,40
06085510500,085,510500,10,0,10
06085510900,085,510900,0,0,0
06037228210,037,228210,0,32,32
06037231210,037,231210,31,0,31
06037231720,037,231720,23,0,23
06037231800,037,231800,0,0,0
06071011101,071,011101,0,0,0
06071011102,071,011102,7,8,15
06071011203,071,011203,0,0,0
06071011204,071,011204,0,0,0
06071011205,071,011205,0,2,2
06071011206,071,011206,0,0,0
06071011401,071,011401,0,0,0
06071011403,071,011403,0,0,0
06071011404,071,011404,18,0,18
06071012001,071,012001,5,44,49
06071012002,071,012002,0,115,115
06071012101,071,012101,10,0,10
06071012103,071,012103,0,1,1
06071012104,071,012104,0,29,29
06071012200,071,012200,65,0,65
06037269905,037,269905,9,0,9
06037269906,037,269906,45,0,45
06037269907,037,269907,11,0,11
06037271901,037,271901,8,0,8
06037271902,037,271902,16,27,43
06037272201,037,272201,4,0,4
06037272202,037,272202,29,10,39
06037273402,037,273402,16,0,16
06037273502,037,273502,24,0,24
06037273902,037,273902,0,0,0
06037275101,037,275101,12,7,19
06037274202,037,274202,18,0,18
06037275102,037,275102,17,0,17
06037275602,037,275602,28,61,89
06037276603,037,276603,14,21,35
06037276604,037,276604,0,0,0
06037275500,037,275500,0,23,23
06001443321,001,443321,0,0,0
06001444301,001,444301,0,10,10
06001444601,001,444601,29,0,29
06001443322,001,443322,26,5,31
06001444302,001,444302,7,0,7
06001444602,001,444602,44,0,44
06001450102,001,450102,24,0,24
06001450501,001,450501,30,0,30
06001450502,001,450502,73,0,73
06001450744,001,450744,28,20,48
06001450745,001,450745,0,0,0
06001450101,001,450101,124,14,138
06059099242,059,099242,8,0,8
06059099245,059,099245,0,0,0
06059099309,059,099309,0,0,0
06059099404,059,099404,26,44,70
06059099307,059,099307,11,9,20
06059099408,059,099408,28,21,49
06059099240,059,099240,25,0,25
06065043809,065,043809,6,0,6
06065044102,065,044102,0,10,10
06065044402,065,044402,55,17,72
06065044509,065,044509,32,8,40
06065044602,065,044602,0,0,0
06065042410,065,042410,35,0,35
06065042213,065,042213,24,28,52
06065042411,065,042411,0,0,0
06065042412,065,042412,18,0,18
06065031701,065,031701,0,0,0
06065042617,065,042617,60,43,103
06065042618,065,042618,51,13,64
06065042619,065,042619,42,0,42
06065042620,065,042620,150,133,283
06065042621,065,042621,7,48,55
06065042622,065,042622,49,14,63
06065042623,065,042623,58,0,58
06065042624,065,042624,23,9,32
06065042724,065,042724,12,0,12
06065042728,065,042728,0,0,0
06065042729,065,042729,105,23,128
06065042730,065,042730,0,0,0
06065042726,065,042726,34,77,111
06085512401,085,512401,28,14,42
06085500100,085,500100,105,6,111
06085500400,085,500400,13,0,13
06085500500,085,500500,14,0,14
06085501600,085,501600,39,46,85
06085501800,085,501800,6,0,6
06085501900,085,501900,64,13,77
06085502002,085,502002,6,0,6
06085502702,085,502702,37,0,37
06065041203,065,041203,0,4,4
06065041812,065,041812,10,0,10
06037267502,037,267502,0,0,0
06037267700,037,267700,28,0,28
06037270200,037,270200,0,0,0
06037271200,037,271200,16,0,16
06037272100,037,272100,23,12,35
06037272301,037,272301,24,0,24
06037272302,037,272302,29,0,29
06037275400,037,275400,26,0,26
06037276601,037,276601,0,0,0
06037291110,037,291110,0,44,44
06037291120,037,291120,16,0,16
06037294610,037,294610,16,0,16
06037294620,037,294620,7,0,7
06037294830,037,294830,9,4,13
06037296500,037,296500,0,4,4
06037620702,037,620702,79,0,79
06037621400,037,621400,35,0,35
06073011902,073,011902,19,0,19
06073013909,073,013909,11,16,27
06073016302,073,016302,21,14,35
06073010112,073,010112,35,44,79
06073002301,073,002301,28,0,28
06073003404,073,003404,17,0,17
06073018903,073,018903,27,64,91
06073020208,073,020208,22,0,22
06073008337,073,008337,16,12,28
06073010005,073,010005,57,32,89
06073012402,073,012402,32,0,32
06073013801,073,013801,73,0,73
06073013906,073,013906,5,22,27
06073010110,073,010110,41,70,111
06073016807,073,016807,40,0,40
06073019809,073,019809,16,0,16
06073020026,073,020026,11,63,74
06073020027,073,020027,13,0,13
06073017056,073,017056,82,0,82
06073018614,073,018614,53,0,53
06073020028,073,020028,10,0,10
06073020029,073,020029,30,27,57
06059052425,059,052425,0,0,0
06059052506,059,052506,0,4,4
06059052524,059,052524,53,19,72
06059062614,059,062614,101,0,101
06059062625,059,062625,27,0,27
06059062635,059,062635,42,9,51
06073020213,073,020213,23,19,42
06073020214,073,020214,20,59,79
06073020308,073,020308,9,0,9
06073020309,073,020309,29,0,29
06073020810,073,020810,19,6,25
06073020811,073,020811,32,0,32
06073021205,073,021205,123,15,138
06073021206,073,021206,48,40,88
06073021400,073,021400,12,0,12
06073021500,073,021500,34,0,34
06073021600,073,021600,16,0,16
06073021800,073,021800,8,0,8
06001403501,001,403501,19,0,19
06001403502,001,403502,0,0,0
06001403701,001,403701,0,0,0
06001403702,001,403702,9,0,9
06001404102,001,404102,36,0,36
06001404101,001,404101,32,16,48
06001405301,001,405301,10,0,10
06001405302,001,405302,0,12,12
06001405401,001,405401,10,0,10
06001406602,001,406602,8,0,8
06001405402,001,405402,0,10,10
06001405901,001,405901,13,49,62
06001406601,001,406601,45,11,56
06001405902,001,405902,12,11,23
06001407101,001,407101,44,0,44
06001407102,001,407102,0,0,0
06001410500,001,410500,5,17,22
06001425101,001,425101,0,0,0
06037221401,037,221401,0,5,5
06001407000,001,407000,0,0,0
06001407200,001,407200,74,37,111
06001407400,001,407400,14,15,29
06001408300,001,408300,0,93,93
06001410100,001,410100,6,16,22
06001420600,001,420600,12,0,12
06001421100,001,421100,0,0,0
06001421400,001,421400,0,0,0
06001422100,001,422100,0,0,0
06001423700,001,423700,18,23,41
06001423800,001,423800,11,0,11
06001426200,001,426200,29,0,29
06001428000,001,428000,0,0,0
06001430300,001,430300,0,0,0
06001431200,001,431200,43,35,78
06001432100,001,432100,14,0,14
06001432300,001,432300,24,42,66
06001432600,001,432600,28,58,86
06001400500,001,400500,64,0,64
06001401600,001,401600,0,14,14
06001402500,001,402500,7,5,12
06001403900,001,403900,0,27,27
06001407600,001,407600,0,61,61
06001408400,001,408400,0,38,38
06001408900,001,408900,13,12,25
06037264000,037,264000,8,0,8
06037265304,037,265304,0,0,0
06037265410,037,265410,18,0,18
06037269100,037,269100,27,0,27
06037269700,037,269700,0,0,0
06037270300,037,270300,5,0,5
06037271702,037,271702,20,0,20
06037273700,037,273700,17,0,17
06037275302,037,275302,86,0,86
06037293301,037,293301,30,0,30
06073008600,073,008600,0,28,28
06073009000,073,009000,44,0,44
06073009102,073,009102,40,4,44
06037115202,037,115202,33,14,47
06037115401,037,115401,44,21,65
06065043315,065,043315,0,13,13
06065043807,065,043807,52,0,52
06065044101,065,044101,5,17,22
06065044200,065,044200,44,39,83
06065044806,065,044806,0,0,0
06065044807,065,044807,0,0,0
06065044907,065,044907,101,60,161
06065030400,065,030400,98,56,154
06065045209,065,045209,22,0,22
06065045502,065,045502,0,10,10
06065045704,065,045704,5,22,27
06065045705,065,045705,12,51,63
06065046405,065,046405,0,0,0
06085512305,085,512305,0,0,0
06085504421,085,504421,45,0,45
06085504506,085,504506,40,0,40
06085504700,085,504700,20,0,20
06085504805,085,504805,0,14,14
06085505600,085,505600,3,12,15
06085506101,085,506101,14,0,14
06085506203,085,506203,16,0,16
06085506802,085,506802,32,19,51
06085506900,085,506900,0,0,0
06085507001,085,507001,15,0,15
06085507302,085,507302,0,0,0
06085507702,085,507702,0,0,0
06085507805,085,507805,0,0,0
06085507806,085,507806,50,0,50
06085508101,085,508101,0,24,24
06085509202,085,509202,14,0,14
06085509304,085,509304,0,0,0
06085509401,085,509401,22,0,22
06059011300,059,011300,84,0,84
06059011503,059,011503,0,0,0
06059011716,059,011716,30,0,30
06059011717,059,011717,31,8,39
06059011720,059,011720,0,0,0
06059011721,059,011721,26,0,26
06059021802,059,021802,164,0,164
06059021816,059,021816,38,0,38
06059021827,059,021827,0,0,0
06059021913,059,021913,18,21,39
06059021915,059,021915,9,9,18
06059032030,059,032030,29,0,29
06059032036,059,032036,28,0,28
06059032039,059,032039,69,55,124
06059032040,059,032040,28,5,33
06065040302,065,040302,85,16,101
06065040701,065,040701,20,0,20
06065040806,065,040806,11,4,15
06065041202,065,041202,20,5,25
06065041410,065,041410,0,22,22
06065041600,065,041600,46,48,94
06065041703,065,041703,29,0,29
06065041002,065,041002,14,71,85
06065041403,065,041403,21,23,44
06065041409,065,041409,77,0,77
06065041704,065,041704,6,0,6
06065041805,065,041805,35,9,44
06065042004,065,042004,0,0,0
06065042402,065,042402,34,0,34
06065042716,065,042716,20,12,32
06065042723,065,042723,9,0,9
06065043001,065,043001,45,34,79
06065043005,065,043005,9,0,9
06065043217,065,043217,0,0,0
06065043222,065,043222,9,0,9
06065043306,065,043306,14,0,14
06065043403,065,043403,0,14,14
06065043508,065,043508,52,0,52
06065043509,065,043509,18,25,43
06065044911,065,044911,68,13,81
06037430721,037,430721,0,0,0
06037432901,037,432901,18,10,28
06037460600,037,460600,19,0,19
06037700200,037,700200,0,0,0
06037601301,037,601301,12,18,30
06037603004,037,603004,12,0,12
06037920109,037,920109,30,10,40
06037403403,037,403403,9,0,9
06037535802,037,535802,17,15,32
06065040503,065,040503,0,0,0
06065040702,065,040702,0,0,0
06065040808,065,040808,98,13,111
06065040809,065,040809,23,0,23
06065041408,065,041408,67,20,87
06065041500,065,041500,24,13,37
06037402501,037,402501,51,31,82
06037402600,037,402600,39,12,51
06037402902,037,402902,38,0,38
06037403000,037,403000,0,69,69
06037403322,037,403322,40,0,40
06037403325,037,403325,15,0,15
06037403600,037,403600,81,52,133
06037403722,037,403722,7,18,25
06037404701,037,404701,43,0,43
06037404703,037,404703,21,11,32
06037405101,037,405101,58,17,75
06037232600,037,232600,21,68,89
06037234000,037,234000,44,10,54
06037234300,037,234300,0,0,0
06037237300,037,237300,31,0,31
06037237500,037,237500,20,13,33
06037199120,037,199120,40,17,57
06037201301,037,201301,0,14,14
06037203600,037,203600,17,0,17
06037204110,037,204110,30,0,30
06037204420,037,204420,6,8,14
06037204600,037,204600,33,9,42
06037204920,037,204920,0,0,0
06037206300,037,206300,0,0,0
06037920023,037,920023,10,15,25
06037920033,037,920033,0,0,0
06037920039,037,920039,3,0,3
06037920041,037,920041,18,4,22
06037920200,037,920200,0,0,0
06037920303,037,920303,0,0,0
06037920322,037,920322,8,9,17
06037910603,037,910603,7,0,7
06037910705,037,910705,0,0,0
06037920028,037,920028,64,0,64
06037920032,037,920032,39,7,46
06037920034,037,920034,14,0,14
06037920312,037,920312,27,0,27
06037920330,037,920330,38,0,38
06037930200,037,930200,0,0,0
06037540000,037,540000,48,14,62
06037540902,037,540902,8,38,46
06037541500,037,541500,13,60,73
06037542401,037,542401,12,0,12
06037543201,037,543201,46,0,46
06037543602,037,543602,19,12,31
06037551202,037,551202,52,0,52
06037553602,037,553602,56,10,66
06037553702,037,553702,34,0,34
06037554514,037,554514,30,14,44
06037531901,037,531901,0,0,0
06037533107,037,533107,19,35,54
06037533703,037,533703,42,23,65
06037534201,037,534201,12,44,56
06037300800,037,300800,14,8,22
06067001200,067,001200,12,0,12
06067001700,067,001700,0,16,16
06065041201,065,041201,0,0,0
06065041406,065,041406,23,17,40
06065041809,065,041809,23,29,52
06065041906,065,041906,20,11,31
06065030300,065,030300,15,18,33
06065030800,065,030800,0,0,0
06065031100,065,031100,17,7,24
06065040301,065,040301,19,20,39
06065040605,065,040605,0,8,8
06065040901,065,040901,60,33,93
06065041404,065,041404,28,7,35
06065041405,065,041405,0,0,0
06065030200,065,030200,12,0,12
06065030601,065,030601,13,14,27
06065044403,065,044403,29,0,29
06065044915,065,044915,27,100,127
06065045103,065,045103,0,0,0
06065044510,065,044510,46,56,102
06065044300,065,044300,0,85,85
06065045000,065,045000,0,0,0
06065045108,065,045108,15,0,15
06065045605,065,045605,32,0,32
06065046103,065,046103,43,5,48
06065046404,065,046404,20,30,50
06085503601,085,503601,23,5,28
06085503707,085,503707,77,10,87
06085503709,085,503709,9,0,9
06085504102,085,504102,38,10,48
06085504308,085,504308,25,0,25
06085504416,085,504416,70,15,85
06085504422,085,504422,0,0,0
06085504602,085,504602,24,0,24
06085505100,085,505100,46,13,59
06037297110,037,297110,26,18,44
06037574201,037,574201,9,0,9
06037575002,037,575002,59,0,59
06037575202,037,575202,0,0,0
06037576601,037,576601,34,0,34
06037576802,037,576802,0,0,0
06037577602,037,577602,0,27,27
06037600201,037,600201,45,17,62
06037600801,037,600801,0,0,0
06037600912,037,600912,27,40,67
06037601402,037,601402,8,22,30
06037601502,037,601502,6,37,43
06037602103,037,602103,38,0,38
06037602106,037,602106,25,78,103
06037602600,037,602600,52,27,79
06037602700,037,602700,0,0,0
06037602900,037,602900,59,6,65
06037620101,037,620101,56,18,74
06037650102,037,650102,13,0,13
06037650502,037,650502,0,0,0
06037650603,037,650603,0,0,0
06037650800,037,650800,20,0,20
06037670406,037,670406,5,0,5
06037700700,037,700700,0,0,0
06037702802,037,702802,23,0,23
06037900605,037,900605,41,0,41
06037900701,037,900701,0,0,0
06037901007,037,901007,0,0,0
06037273100,037,273100,16,16,32
06037265303,037,265303,7,0,7
06037267402,037,267402,8,0,8
06037273300,037,273300,17,0,17
06037920026,037,920026,0,0,0
06037920035,037,920035,0,0,0
06037700901,037,700901,14,8,22
06037701100,037,701100,0,0,0
06037195802,037,195802,6,27,33
06037191120,037,191120,15,0,15
06037191410,037,191410,13,80,93
06037195400,037,195400,19,0,19
06037197700,037,197700,0,4,4
06037199000,037,199000,29,8,37
06037199300,037,199300,17,0,17
06059099248,059,099248,24,37,61
06059099250,059,099250,41,8,49
06059099504,059,099504,15,0,15
06059099604,059,099604,27,32,59
06059099605,059,099605,46,10,56
06059099801,059,099801,16,0,16
06059110003,059,110003,13,0,13
06059110005,059,110005,0,0,0
06059110012,059,110012,0,0,0
06059110110,059,110110,65,14,79
06037543603,037,543603,0,0,0
06037543703,037,543703,9,21,30
06037701201,037,701201,0,0,0
06037701702,037,701702,55,0,55
06037554201,037,554201,8,0,8
06037555001,037,555001,7,15,22
06037570202,037,570202,52,34,86
06037570203,037,570203,27,0,27
06037570901,037,570901,65,12,77
06037570902,037,570902,69,12,81
06037571000,037,571000,62,12,74
06037571701,037,571701,0,17,17
06037572700,037,572700,4,0,4
06037573100,037,573100,128,0,128
06037573401,037,573401,8,0,8
06037574000,037,574000,25,0,25
06037574700,037,574700,0,0,0
06037574901,037,574901,42,0,42
06037575201,037,575201,0,0,0
06037575300,037,575300,0,0,0
06037575401,037,575401,8,44,52
06037575500,037,575500,0,0,0
06073020021,073,020021,22,12,34
06073020202,073,020202,14,50,64
06073020500,073,020500,10,62,72
06085502901,085,502901,20,15,35
06085502902,085,502902,88,0,88
06085504507,085,504507,70,0,70
06085504601,085,504601,11,0,11
06085504802,085,504802,31,0,31
06085504901,085,504901,195,0,195
06085505304,085,505304,30,0,30
06085505305,085,505305,17,98,115
06085506503,085,506503,64,0,64
06085504314,085,504314,67,12,79
06085504317,085,504317,24,0,24
06085504410,085,504410,10,56,66
06085504412,085,504412,39,8,47
06085511400,085,511400,8,0,8
06085509902,085,509902,45,0,45
06085510700,085,510700,43,0,43
06085511702,085,511702,5,0,5
06085512022,085,512022,80,0,80
06085512027,085,512027,57,0,57
06085512032,085,512032,20,0,20
06073008335,073,008335,102,0,102
06073008336,073,008336,0,0,0
06073008344,073,008344,27,0,27
06073008348,073,008348,20,0,20
06073008501,073,008501,99,0,99
06073008513,073,008513,70,0,70
06073016402,073,016402,29,26,55
06059062800,059,062800,0,0,0
06059063101,059,063101,0,14,14
06059063301,059,063301,18,0,18
06059063302,059,063302,36,0,36
06059063500,059,063500,45,0,45
06059063808,059,063808,9,7,16
06059074102,059,074102,23,47,70
06059074103,059,074103,40,9,49
06059074106,059,074106,45,52,97
06059074300,059,074300,5,18,23
06059074602,059,074602,19,17,36
06059074701,059,074701,72,15,87
06059087801,059,087801,26,37,63
06059087105,059,087105,0,14,14
06059087200,059,087200,21,0,21
06073017020,073,017020,19,0,19
06073017501,073,017501,10,0,10
06073009703,073,009703,55,0,55
06073010012,073,010012,24,0,24
06073011802,073,011802,0,19,19
06073002705,073,002705,0,0,0
06073003211,073,003211,0,24,24
06073006500,073,006500,0,30,30
06073008511,073,008511,0,19,19
06073012700,073,012700,60,0,60
06073018519,073,018519,17,10,27
06059011403,059,011403,36,0,36
06059001102,059,001102,40,29,69
06059001507,059,001507,82,22,104
06059011101,059,011101,66,0,66
06059011708,059,011708,26,0,26
06059011710,059,011710,26,0,26
06059021903,059,021903,36,0,36
06059021912,059,021912,52,0,52
06059021920,059,021920,37,0,37
06059032003,059,032003,10,0,10
06059011707,059,011707,13,48,61
06059011722,059,011722,12,0,12
06059021916,059,021916,24,0,24
06059032041,059,032041,0,0,0
06059042313,059,042313,47,0,47
06059011711,059,011711,20,0,20
06059021918,059,021918,17,7,24
06059032031,059,032031,11,0,11
06059063102,059,063102,60,9,69
06059052505,059,052505,0,0,0
06059062605,059,062605,0,0,0
06059063601,059,063601,8,8,16
06059074111,059,074111,13,10,23
06071004503,071,004503,10,0,10
06071003900,071,003900,10,0,10
06071005600,071,005600,26,47,73
06073019404,073,019404,11,15,26
06073002002,073,002002,8,0,8
06073017808,073,017808,0,11,11
06073019101,073,019101,57,7,64
06037432801,037,432801,0,0,0
06037460000,037,460000,7,0,7
06037460501,037,460501,31,0,31
06037131300,037,131300,37,0,37
06037131400,037,131400,65,0,65
06037131900,037,131900,12,12,24
06037132300,037,132300,0,0,0
06037133000,037,133000,14,10,24
06037134101,037,134101,9,0,9
06037480704,037,480704,22,0,22
06037480803,037,480803,0,0,0
06037481201,037,481201,8,0,8
06037482521,037,482521,37,0,37
06037502301,037,502301,7,50,57
06037482502,037,482502,22,3,25
06037501300,037,501300,59,0,59
06037501700,037,501700,0,31,31
06037134800,037,134800,14,0,14
06037134901,037,134901,17,48,65
06037530801,037,530801,23,19,42
06037530802,037,530802,9,0,9
06037531302,037,531302,0,23,23
06037532302,037,532302,18,10,28
06037532603,037,532603,36,43,79
06037533104,037,533104,31,0,31
06037533201,037,533201,7,14,21
06037533300,037,533300,32,14,46
06037533702,037,533702,0,10,10
06037241400,037,241400,22,30,52
06037242200,037,242200,30,0,30
06037262302,037,262302,0,0,0
06037400205,037,400205,6,0,6
06037402404,037,402404,0,0,0
06037108104,037,108104,6,0,6
06037113301,037,113301,40,0,40
06037117303,037,117303,0,0,0
06037190510,037,190510,20,23,43
06037192620,037,192620,0,8,8
06037197410,037,197410,38,0,38
06037203710,037,203710,0,16,16
06037577000,037,577000,21,31,52
06037599000,037,599000,29,0,29
06037601303,037,601303,11,24,35
06037602104,037,602104,44,56,100
06037189500,037,189500,0,0,0
06037650602,037,650602,61,0,61
06037650902,037,650902,114,32,146
06037131200,037,131200,7,0,7
06037131600,037,131600,35,16,51
06037132700,037,132700,36,15,51
06037181300,037,181300,111,0,111
06037183300,037,183300,7,0,7
06037183510,037,183510,31,27,58
06037183810,037,183810,17,0,17
06037188100,037,188100,13,41,54
06037189300,037,189300,10,0,10
06037189800,037,189800,37,0,37
06037191000,037,191000,0,0,0
06037191201,037,191201,0,0,0
06037191710,037,191710,0,17,17
06037192700,037,192700,11,0,11
06037194200,037,194200,57,0,57
06037197300,037,197300,0,0,0
06037197500,037,197500,0,0,0
06037197600,037,197600,13,0,13
06037199202,037,199202,13,14,27
06037201302,037,201302,52,15,67
06037408133,037,408133,66,23,89
06037408135,037,408135,42,0,42
06037408211,037,408211,28,6,34
06037320202,037,320202,88,0,88
06037311801,037,311801,18,0,18
06037311802,037,311802,0,18,18
06037553601,037,553601,0,17,17
06037403407,037,403407,3,0,3
06037122120,037,122120,0,39,39
06037123010,037,123010,14,0,14
06037128910,037,128910,28,10,38
06037134305,037,134305,22,17,39
06037134710,037,134710,37,0,37
06037135202,037,135202,0,21,21
06037137302,037,137302,13,0,13
06037139802,037,139802,4,0,4
06037141302,037,141302,0,0,0
06037143100,037,143100,76,0,76
06037143800,037,143800,33,0,33
06037402702,037,402702,53,6,59
06037402703,037,402703,0,6,6
06037403200,037,403200,0,0,0
06037403303,037,403303,0,0,0
06037403702,037,403702,0,0,0
06037119800,037,119800,0,0,0
06037120010,037,120010,3,19,22
06037122200,037,122200,24,0,24
06037122420,037,122420,0,7,7
06037404402,037,404402,23,16,39
06037406300,037,406300,14,0,14
06037800330,037,800330,0,0,0
06037206010,037,206010,11,0,11
06037207900,037,207900,0,0,0
06037208902,037,208902,11,48,59
06037208904,037,208904,7,23,30
06037209402,037,209402,0,23,23
06037211000,037,211000,17,0,17
06037211120,037,211120,0,0,0
06037211320,037,211320,0,0,0
06037213401,037,213401,48,80,128
06037213402,037,213402,20,0,20
06037220100,037,220100,10,0,10
06071008705,071,008705,0,0,0
06071008708,071,008708,63,0,63
06071009107,071,009107,27,0,27
06071010011,071,010011,0,0,0
06071011500,071,011500,10,0,10
06071001803,071,001803,0,0,0
06071002602,071,002602,32,45,77
06071002901,071,002901,17,0,17
06071002902,071,002902,34,10,44
06071010018,071,010018,15,0,15
06071009500,071,009500,0,0,0
06071009713,071,009713,65,81,146
06071009716,071,009716,42,104,146
06071010402,071,010402,83,0,83
06071010409,071,010409,0,15,15
06071010411,071,010411,21,0,21
06001440100,001,440100,26,0,26
06001441301,001,441301,7,0,7
06001421800,001,421800,36,0,36
06001442800,001,442800,8,7,15
06001443102,001,443102,5,14,19
06001443200,001,443200,38,11,49
06001444100,001,444100,18,0,18
06001444500,001,444500,40,29,69
06001450601,001,450601,2,0,2
06001450741,001,450741,17,0,17
06001451101,001,451101,75,0,75
06001441923,001,441923,53,20,73
06059087403,059,087403,24,17,41
06059088001,059,088001,15,0,15
06059088106,059,088106,45,0,45
06059088402,059,088402,23,78,101
06059088902,059,088902,0,0,0
06059088904,059,088904,54,0,54
06059099233,059,099233,11,0,11
06059099305,059,099305,51,13,64
06071010410,071,010410,40,10,50
06071000104,071,000104,32,0,32
06071000401,071,000401,8,44,52
06071001703,071,001703,9,27,36
06071002301,071,002301,23,0,23
06071002501,071,002501,12,100,112
06071003401,071,003401,29,0,29
06071003403,071,003403,8,0,8
06071004900,071,004900,41,36,77
06071005800,071,005800,0,14,14
06071007000,071,007000,13,41,54
06071005200,071,005200,0,9,9
06059032029,059,032029,25,0,25
06059032049,059,032049,60,0,60
06059032054,059,032054,83,0,83
06059032056,059,032056,111,0,111
06059001201,059,001201,0,23,23
06001435400,001,435400,0,0,0
06001436000,001,436000,63,0,63
06001436601,001,436601,16,26,42
06001437200,001,437200,52,19,71
06001440305,001,440305,23,7,30
06001438400,001,438400,9,0,9
06001440306,001,440306,41,0,41
06001440332,001,440332,10,0,10
06001441521,001,441521,38,0,38
06001442900,001,442900,14,0,14
06001443002,001,443002,0,0,0
06001443103,001,443103,18,0,18
06001450400,001,450400,98,17,115
06001450603,001,450603,73,0,73
06001450606,001,450606,23,5,28
06001451102,001,451102,0,0,0
06001451202,001,451202,38,0,38
06001422700,001,422700,0,0,0
06001422400,001,422400,16,0,16
06001422500,001,422500,0,0,0
06037500500,037,500500,4,34,38
06037500900,037,500900,19,19,38
06037501400,037,501400,6,18,24
06037501501,037,501501,0,7,7
06037501802,037,501802,18,11,29
06037501900,037,501900,0,0,0
06037502401,037,502401,59,20,79
06037401202,037,401202,0,0,0
06037401311,037,401311,10,10,20
06037401703,037,401703,15,0,15
06037122410,037,122410,3,0,3
06037123103,037,123103,14,0,14
06037120020,037,120020,8,0,8
06037119900,037,119900,0,58,58
06037120300,037,120300,0,16,16
06037121210,037,121210,0,28,28
06037125600,037,125600,11,0,11
06037123410,037,123410,0,61,61
06037124700,037,124700,61,0,61
06037125320,037,125320,58,0,58
06037128210,037,128210,26,37,63
06037128220,037,128220,33,20,53
06037123601,037,123601,23,6,29
06037123510,037,123510,0,17,17
06037123520,037,123520,48,0,48
06037123700,037,123700,32,63,95
06037124102,037,124102,0,29,29
06037124201,037,124201,0,0,0
06037125200,037,125200,27,0,27
06037125310,037,125310,26,0,26
06037127210,037,127210,55,27,82
06037131020,037,131020,3,0,3
06037480011,037,480011,34,0,34
06037480600,037,480600,58,29,87
06037481712,037,481712,39,27,66
06037481713,037,481713,5,13,18
06037482303,037,482303,0,28,28
06037482304,037,482304,21,0,21
06037500800,037,500800,62,22,84
06037503601,037,503601,32,8,40
06037503602,037,503602,0,0,0
06037503702,037,503702,6,0,6
06037504002,037,504002,30,0,30
06037406602,037,406602,10,0,10
06037407301,037,407301,44,0,44
06037407702,037,407702,60,90,150
06037123206,037,123206,19,0,19
06037123301,037,123301,12,39,51
06037534302,037,534302,12,0,12
06037920029,037,920029,48,0,48
06037920040,037,920040,69,26,95
06037920043,037,920043,12,24,36
06037920104,037,920104,21,0,21
06037534802,037,534802,9,0,9
06073008509,073,008509,63,34,97
06073008510,073,008510,44,0,44
06073009505,073,009505,102,0,102
06073009509,073,009509,46,0,46
06073009705,073,009705,44,11,55
06073009902,073,009902,0,0,0
06073010004,073,010004,26,101,127
06073010103,073,010103,12,26,38
06059042112,059,042112,17,0,17
06059042205,059,042205,0,17,17
06059042307,059,042307,25,0,25
06059042323,059,042323,0,0,0
06059042328,059,042328,0,0,0
06059042339,059,042339,14,0,14
06059062633,059,062633,54,0,54
06059062636,059,062636,56,27,83
06059062641,059,062641,42,0,42
06037265520,037,265520,36,0,36
06037143700,037,143700,11,0,11
06037181500,037,181500,96,0,96
06037183820,037,183820,18,0,18
06037189600,037,189600,0,0,0
06037503000,037,503000,22,14,36
06037503301,037,503301,24,0,24
06037128102,037,128102,39,10,49
06037128601,037,128601,20,19,39
06037128602,037,128602,0,0,0
06037128801,037,128801,20,0,20
06037128802,037,128802,118,0,118
06037131701,037,131701,20,0,20
06037131702,037,131702,7,10,17
06037132001,037,132001,21,37,58
06037132002,037,132002,13,0,13
06037132101,037,132101,6,0,6
06037132102,037,132102,20,18,38
06037600601,037,600601,9,0,9
06037276100,037,276100,0,0,0
06037300100,037,300100,0,0,0
06037302201,037,302201,51,0,51
06037190301,037,190301,0,50,50
06037197420,037,197420,0,8,8
06037205110,037,205110,12,0,12
06037208000,037,208000,40,0,40
06037209401,037,209401,0,45,45
06037214800,037,214800,16,0,16
06037221900,037,221900,10,0,10
06037229300,037,229300,15,38,53
06037400207,037,400207,9,2,11
06037400403,037,400403,15,0,15
06037400404,037,400404,0,0,0
06037400501,037,400501,14,7,21
06037401303,037,401303,0,0,0
06037401304,037,401304,26,0,26
06037402001,037,402001,26,0,26
06037402002,037,402002,0,28,28
06037402303,037,402303,0,21,21
06037402304,037,402304,16,9,25
06037402405,037,402405,4,0,4
06037402705,037,402705,6,13,19
06037402706,037,402706,0,11,11
06037402406,037,402406,17,11,28
06037402803,037,402803,8,0,8
06037402804,037,402804,13,13,26
06037402903,037,402903,0,13,13
06037402904,037,402904,0,15,15
06037404201,037,404201,44,0,44
06037404202,037,404202,9,0,9
06037404503,037,404503,0,30,30
06037404504,037,404504,6,0,6
06037405301,037,405301,6,27,33
06037405302,037,405302,24,44,68
06037405701,037,405701,25,6,31
06037405702,037,405702,7,25,32
06037406701,037,406701,16,4,20
06037406702,037,406702,4,0,4
06037406901,037,406901,20,0,20
06037406902,037,406902,40,11,51
06037407501,037,407501,33,15,48
06037407502,037,407502,0,27,27
06037407601,037,407601,9,46,55
06059032057,059,032057,60,0,60
06059032058,059,032058,228,0,228
06059032059,059,032059,56,23,79
06059042114,059,042114,69,0,69
06059042203,059,042203,84,0,84
06059042312,059,042312,99,0,99
06059011402,059,011402,6,0,6
06059021813,059,021813,0,0,0
06059021814,059,021814,15,0,15
06059052410,059,052410,22,0,22
06059052420,059,052420,182,0,182
06059052502,059,052502,17,0,17
06059001103,059,001103,72,0,72
06059001501,059,001501,69,41,110
06059001503,059,001503,39,0,39
06059001901,059,001901,25,0,25
06059042334,059,042334,0,9,9
06059052417,059,052417,71,0,71
06059052513,059,052513,0,0,0
06059062610,059,062610,0,0,0
06059062626,059,062626,10,9,19
06059062631,059,062631,0,0,0
06085509801,085,509801,27,0,27
06085512307,085,512307,11,0,11
06085503204,085,503204,27,70,97
06085503210,085,503210,37,0,37
06085503401,085,503401,6,0,6
06085503507,085,503507,9,8,17
06085512019,085,512019,11,25,36
06085512020,085,512020,123,0,123
06085512024,085,512024,37,0,37
06085512402,085,512402,0,0,0
06085512506,085,512506,51,26,77
06037310702,037,310702,0,0,0
06037311700,037,311700,0,0,0
06037401002,037,401002,11,22,33
06037402102,037,402102,19,0,19
06037403305,037,403305,7,0,7
06037403321,037,403321,36,0,36
06037119700,037,119700,0,0,0
06037117530,037,117530,14,105,119
06037119310,037,119310,33,0,33
06037119400,037,119400,11,16,27
06037109200,037,109200,18,0,18
06037113212,037,113212,0,0,0
06037113231,037,113231,0,0,0
06067008501,067,008501,55,0,55
06067009311,067,009311,69,33,102
06073009201,073,009201,124,37,161
06073009706,073,009706,87,0,87
06073010010,073,010010,42,0,42
06073010104,073,010104,0,2,2
06073010106,073,010106,18,0,18
06073010300,073,010300,0,0,0
06073010402,073,010402,82,72,154
06073008328,073,008328,12,26,38
06073008330,073,008330,56,0,56
06073008346,073,008346,34,15,49
06073008352,073,008352,11,0,11
06073009103,073,009103,55,0,55
06073009304,073,009304,32,27,59
06073004800,073,004800,0,34,34
06073006600,073,006600,0,8,8
06073007002,073,007002,0,20,20
06073007502,073,007502,22,29,51
06073009502,073,009502,61,0,61
06073008701,073,008701,11,0,11
06073009104,073,009104,25,0,25
06073009202,073,009202,72,14,86
06073009506,073,009506,44,0,44
06073009602,073,009602,35,0,35
06073009604,073,009604,23,0,23
06073010001,073,010001,22,0,22
06073010013,073,010013,24,0,24
06073010015,073,010015,22,0,22
06073010111,073,010111,6,35,41
06073010502,073,010502,38,21,59
06085505202,085,505202,13,0,13
06073003001,073,003001,69,23,92
06067009317,067,009317,68,10,78
06037199700,037,199700,0,10,10
06037201402,037,201402,0,35,35
06037203900,037,203900,0,0,0
06037603200,037,603200,22,0,22
06037609900,037,609900,0,0,0
06037620303,037,620303,25,0,25
06037552800,037,552800,6,0,6
06037553300,037,553300,10,10,20
06037550800,037,550800,60,48,108
06059074803,059,074803,27,33,60
06059074902,059,074902,29,47,76
06059075505,059,075505,20,0,20
06059075512,059,075512,40,5,45
06059075703,059,075703,20,0,20
06059075805,059,075805,18,0,18
06037190802,037,190802,6,21,27
06037191301,037,191301,0,0,0
06037191302,037,191302,0,0,0
06037191901,037,191901,7,0,7
06037191902,037,191902,9,0,9
06037192001,037,192001,0,0,0
06037192002,037,192002,26,0,26
06037194101,037,194101,0,0,0
06037194102,037,194102,49,0,49
06037194401,037,194401,0,0,0
06037194402,037,194402,16,0,16
06037195201,037,195201,26,0,26
06037195202,037,195202,17,0,17
06037195803,037,195803,17,16,33
06037195804,037,195804,4,39,43
06037195901,037,195901,15,0,15
06037195902,037,195902,0,0,0
06037195903,037,195903,3,9,12
06037206031,037,206031,15,16,31
06037201601,037,201601,44,22,66
06037201602,037,201602,11,0,11
06037206032,037,206032,33,15,48
06037207101,037,207101,0,0,0
06037207102,037,207102,0,0,0
06037207103,037,207103,0,0,0
06037207301,037,207301,19,0,19
06037207302,037,207302,0,0,0
06037207501,037,207501,20,0,20
06037207502,037,207502,0,0,0
06037208301,037,208301,0,15,15
06037208302,037,208302,0,13,13
06067008119,067,008119,0,27,27
06059062645,059,062645,60,12,72
06059062647,059,062647,0,0,0
06059062702,059,062702,55,0,55
06059063004,059,063004,0,0,0
06059063010,059,063010,78,0,78
06059063400,059,063400,17,8,25
06059063802,059,063802,18,0,18
06059063806,059,063806,23,0,23
06059063906,059,063906,22,0,22
06059074005,059,074005,43,32,75
06059074107,059,074107,31,0,31
06059074109,059,074109,14,31,45
06059074403,059,074403,42,37,79
06059074501,059,074501,0,0,0
06059074801,059,074801,28,66,94
06059075507,059,075507,29,15,44
06059075515,059,075515,80,0,80
06059075810,059,075810,0,0,0
06085509901,085,509901,24,9,33
06085510300,085,510300,8,0,8
06085502909,085,502909,24,16,40
06085512023,085,512023,62,32,94
06085504202,085,504202,34,0,34
06085505302,085,505302,50,0,50
06085506603,085,506603,17,0,17
06073011000,073,011000,0,0,0
06073011300,073,011300,10,0,10
06073012002,073,012002,9,10,19
06073012304,073,012304,0,0,0
06073012900,073,012900,9,0,9
06059076000,059,076000,21,0,21
06059076204,059,076204,7,0,7
06059075605,059,075605,0,23,23
06059075813,059,075813,17,0,17
06059075815,059,075815,49,15,64
06059075902,059,075902,0,9,9
06059076102,059,076102,55,0,55
06071004301,071,004301,85,21,106
06071004302,071,004302,60,23,83
06071004403,071,004403,41,0,41
06071004404,071,004404,0,52,52
06071004505,071,004505,8,28,36
06071004507,071,004507,29,74,103
06071004509,071,004509,31,46,77
06071004510,071,004510,30,0,30
06071004603,071,004603,0,26,26
06071004604,071,004604,47,42,89
06071005701,071,005701,0,18,18
06071006203,071,006203,0,57,57
06071006204,071,006204,7,30,37
06071006601,071,006601,0,33,33
06071006603,071,006603,20,14,34
06071006604,071,006604,0,15,15
06071007109,071,007109,0,33,33
06071007110,071,007110,47,36,83
06071007303,071,007303,0,0,0
06071007305,071,007305,10,17,27
06071007306,071,007306,130,0,130
06071007409,071,007409,18,30,48
06071007410,071,007410,62,0,62
06071007603,071,007603,43,0,43
06071007604,071,007604,14,27,41
06071007903,071,007903,9,0,9
06071007904,071,007904,53,62,115
06071008601,071,008601,12,28,40
06071008602,071,008602,11,0,11
06071008709,071,008709,14,0,14
06071008710,071,008710,16,6,22
06065040403,065,040403,5,0,5
06065040502,065,040502,44,50,94
06065040604,065,040604,0,0,0
06065030900,065,030900,4,7,11
06065030503,065,030503,40,26,66
06065031402,065,031402,21,22,43
06065031704,065,031704,0,0,0
06065040303,065,040303,0,17,17
06065040603,065,040603,8,0,8
06065040903,065,040903,9,5,14
06065041003,065,041003,20,8,28
06065030501,065,030501,0,0,0
06065030602,065,030602,0,0,0
06065030603,065,030603,22,0,22
06065031501,065,031501,20,0,20
06065040202,065,040202,4,27,31
06065040203,065,040203,6,10,16
06065040204,065,040204,12,38,50
06065043313,065,043313,11,0,11
06065043401,065,043401,0,32,32
06065043504,065,043504,27,0,27
06065043802,065,043802,35,42,77
06065043900,065,043900,38,41,79
06065044505,065,044505,0,0,0
06065040201,065,040201,20,25,45
06065031001,065,031001,0,0,0
06065031200,065,031200,0,0,0
06085512025,085,512025,8,3,11
06085511912,085,511912,20,0,20
06085511913,085,511913,34,0,34
06085511914,085,511914,11,0,11
06085512029,085,512029,0,0,0
06085512030,085,512030,26,0,26
06085512034,085,512034,14,0,14
06085512503,085,512503,57,0,57
06085512508,085,512508,75,25,100
06085500300,085,500300,7,0,7
06085500800,085,500800,0,0,0
06085501300,085,501300,14,13,27
06085502910,085,502910,52,0,52
06085503112,085,503112,61,0,61
06085503116,085,503116,91,0,91
06085503207,085,503207,21,0,21
06067001900,067,001900,0,0,0
06073013416,073,013416,38,15,53
06073013417,073,013417,7,0,7
06073014102,073,014102,0,0,0
06073014601,073,014601,15,29,44
06073014700,073,014700,12,157,169
06073015404,073,015404,0,0,0
06073015902,073,015902,11,8,19
06073016202,073,016202,36,0,36
06073016609,073,016609,24,9,33
06073017006,073,017006,11,0,11
06073017029,073,017029,17,0,17
06073017039,073,017039,100,0,100
06073017040,073,017040,30,0,30
06073017048,073,017048,26,0,26
06073017502,073,017502,49,7,56
06073017603,073,017603,6,7,13
06073017701,073,017701,16,0,16
06073018802,073,018802,57,51,108
06037576502,037,576502,41,53,94
06037576503,037,576503,19,23,42
06037576901,037,576901,14,8,22
06037577300,037,577300,24,0,24
06037600100,037,600100,0,47,47
06037600302,037,600302,24,0,24
06037600703,037,600703,5,0,5
06037600802,037,600802,9,0,9
06071001002,071,001002,47,31,78
06071001104,071,001104,7,23,30
06071001101,071,001101,54,35,89
06071001103,071,001103,22,0,22
06071001305,071,001305,32,45,77
06071010700,071,010700,0,69,69
06071010019,071,010019,47,52,99
06071010022,071,010022,10,0,10
06071010024,071,010024,12,0,12
06071011800,071,011800,18,33,51
06071009715,071,009715,16,0,16
06071010012,071,010012,45,0,45
06071010015,071,010015,10,36,46
06071000109,071,000109,54,0,54
06037554302,037,554302,47,0,47
06037554405,037,554405,0,0,0
06037554406,037,554406,14,8,22
06037570403,037,570403,5,39,44
06037571703,037,571703,7,18,25
06037571704,037,571704,16,55,71
06037570404,037,570404,0,44,44
06037571503,037,571503,10,14,24
06037571504,037,571504,30,0,30
06059075806,059,075806,9,0,9
06059075807,059,075807,8,0,8
06059075808,059,075808,23,0,23
06059075809,059,075809,0,0,0
06059075812,059,075812,43,6,49
06059075814,059,075814,0,0,0
06059076101,059,076101,0,0,0
06059076201,059,076201,124,24,148
06059076208,059,076208,17,48,65
06059086304,059,086304,6,0,6
06059086305,059,086305,12,23,35
06059086702,059,086702,24,8,32
06059086902,059,086902,0,0,0
06059087002,059,087002,0,22,22
06059087401,059,087401,86,17,103
06059087404,059,087404,5,38,43
06059087504,059,087504,24,38,62
06059087701,059,087701,29,0,29
06059087901,059,087901,9,0,9
06059088301,059,088301,0,0,0
06059088901,059,088901,27,45,72
06059088903,059,088903,26,0,26
06059088905,059,088905,12,0,12
06001450743,001,450743,18,0,18
06001450746,001,450746,10,0,10
06001450750,001,450750,48,0,48
06001450751,001,450751,102,0,102
06001450752,001,450752,23,0,23
06001451403,001,451403,43,0,43
06001451404,001,451404,19,0,19
06001451504,001,451504,15,0,15
06001451505,001,451505,0,0,0
06001451506,001,451506,11,0,11
06037404801,037,404801,38,65,103
06037405002,037,405002,0,8,8
06037405800,037,405800,28,0,28
06037406402,037,406402,20,0,20
06037406800,037,406800,58,0,58
06065042731,065,042731,17,0,17
06065042732,065,042732,31,0,31
06037261200,037,261200,48,0,48
06037229100,037,229100,11,28,39
06037271100,037,271100,15,0,15
06037275311,037,275311,20,0,20
06037482102,037,482102,8,0,8
06037464100,037,464100,40,0,40
06037481402,037,481402,99,0,99
06037482800,037,482800,14,0,14
06037503201,037,503201,14,0,14
06037651001,037,651001,6,0,6
06037670411,037,670411,11,14,25
06037701000,037,701000,0,0,0
06037702901,037,702901,0,78,78
06037901102,037,901102,0,0,0
06037273600,037,273600,20,0,20
06037274100,037,274100,0,79,79
06065042733,065,042733,56,69,125
06065042737,065,042737,13,0,13
06065042738,065,042738,24,18,42
06065042739,065,042739,41,0,41
06001422600,001,422600,0,0,0
06001423100,001,423100,28,0,28
06001426100,001,426100,48,0,48
06037408134,037,408134,4,0,4
06037408301,037,408301,0,18,18
06037408627,037,408627,6,0,6
06037408703,037,408703,27,0,27
06037430502,037,430502,0,0,0
06037430723,037,430723,10,7,17
06065041905,065,041905,3,17,20
06065041909,065,041909,0,8,8
06065042007,065,042007,0,0,0
06065042009,065,042009,45,31,76
06065042212,065,042212,54,0,54
06065042517,065,042517,0,0,0
06065042715,065,042715,19,197,216
06065042903,065,042903,0,22,22
06065043310,065,043310,48,0,48
06065043505,065,043505,0,0,0
06065043507,065,043507,40,142,182
06065044103,065,044103,0,27,27
06065044104,065,044104,32,6,38
06065044507,065,044507,67,15,82
06065044604,065,044604,5,27,32
06065044916,065,044916,23,29,52
06065041808,065,041808,9,0,9
06065042214,065,042214,118,21,139
06065042403,065,042403,9,0,9
06065042409,065,042409,0,6,6
06065042511,065,042511,22,41,63
06065042516,065,042516,44,0,44
06065042706,065,042706,35,12,47
06065042709,065,042709,0,0,0
06065042717,065,042717,0,13,13
06085503105,085,503105,10,0,10
06085505001,085,505001,88,0,88
06085505301,085,505301,39,0,39
06085500200,085,500200,86,0,86
06085500901,085,500901,0,0,0
06085501501,085,501501,8,20,28
06085502101,085,502101,92,0,92
06085502701,085,502701,22,7,29
06085502903,085,502903,32,0,32
06085503002,085,503002,50,0,50
06059001303,059,001303,39,0,39
06059001403,059,001403,43,0,43
06059001505,059,001505,55,0,55
06059001704,059,001704,42,0,42
06059001705,059,001705,0,9,9
06059001706,059,001706,0,12,12
06059011601,059,011601,0,0,0
06085508203,085,508203,51,8,59
06085508204,085,508204,33,7,40
06085508301,085,508301,0,0,0
06085509302,085,509302,20,0,20
06085509700,085,509700,37,0,37
06037221602,037,221602,5,0,5
06037221402,037,221402,3,0,3
06037534804,037,534804,8,0,8
06037535200,037,535200,10,12,22
06037535300,037,535300,28,34,62
06037535702,037,535702,9,0,9
06037535803,037,535803,22,11,33
06037535901,037,535901,46,45,91
06037541603,037,541603,11,41,52
06037541604,037,541604,41,49,90
06037542501,037,542501,0,0,0
06037543321,037,543321,30,40,70
06037543502,037,543502,0,0,0
06037550100,037,550100,7,24,31
06037550500,037,550500,47,0,47
06037551000,037,551000,13,0,13
06037552200,037,552200,30,2,32
06073008312,073,008312,0,0,0
06073008351,073,008351,50,8,58
06073005900,073,005900,9,0,9
06073007903,073,007903,12,0,12
06073016901,073,016901,52,0,52
06073017401,073,017401,49,0,49
06073013206,073,013206,55,0,55
06073013419,073,013419,87,29,116
06073015406,073,015406,14,0,14
06073017403,073,017403,44,0,44
06073019208,073,019208,24,10,34
06037294200,037,294200,21,44,65
06037294510,037,294510,8,9,17
06037301400,037,301400,9,13,22
06037301501,037,301501,22,0,22
06037301701,037,301701,0,39,39
06037302104,037,302104,36,0,36
06037480703,037,480703,8,24,32
06037480902,037,480902,15,0,15
06037480903,037,480903,26,28,54
06037481002,037,481002,0,0,0
06037481102,037,481102,11,0,11
06037481202,037,481202,11,9,20
06059074200,059,074200,47,16,63
06059074408,059,074408,26,105,131
06037236100,037,236100,0,0,0
06037241120,037,241120,6,4,10
06037301702,037,301702,8,0,8
06037311400,037,311400,12,0,12
06037554002,037,554002,20,0,20
06001982000,001,982000,0,0,0
06001983200,001,983200,4,0,4
06001990000,001,990000,0,0,0
06037204120,037,204120,5,0,5
06037204410,037,204410,5,0,5
06037204910,037,204910,5,16,21
06037205120,037,205120,0,0,0
06037206050,037,206050,0,0,0
06037216200,037,216200,0,43,43
06037216900,037,216900,0,0,0
06037218800,037,218800,0,17,17
06037311500,037,311500,28,14,42
06037302103,037,302103,24,11,35
06037310800,037,310800,8,7,15
06037310900,037,310900,0,51,51
06037320100,037,320100,39,16,55
06037400204,037,400204,42,7,49
06037400302,037,400302,18,12,30
06037401101,037,401101,18,0,18
06037401201,037,401201,6,0,6
06037401601,037,401601,72,5,77
06037402101,037,402101,44,23,67
06065042740,065,042740,0,0,0
06065042741,065,042741,0,15,15
06065042742,065,042742,0,0,0
06065042744,065,042744,4,3,7
06065043008,065,043008,89,83,172
06065042743,065,042743,9,0,9
06065042745,065,042745,9,12,21
06065043007,065,043007,52,13,65
06065043009,065,043009,25,0,25
06065043010,065,043010,39,0,39
06065043227,065,043227,38,0,38
06065043228,065,043228,15,0,15
06065043235,065,043235,51,0,51
06065043229,065,043229,50,15,65
06065043239,065,043239,29,0,29
06065043240,065,043240,42,0,42
06065043242,065,043242,47,0,47
06037651402,037,651402,43,0,43
06037670324,037,670324,15,0,15
06037670326,037,670326,8,0,8
06037670328,037,670328,0,0,0
06037670416,037,670416,12,0,12
06037670602,037,670602,29,0,29
06037700101,037,700101,27,0,27
06037700102,037,700102,39,0,39
06037700501,037,700501,0,23,23
06037700502,037,700502,0,0,0
06037700801,037,700801,13,0,13
06037700802,037,700802,44,0,44
06059042106,059,042106,0,0,0
06059042109,059,042109,0,0,0
06059062646,059,062646,0,0,0
06059063201,059,063201,13,0,13
06059063605,059,063605,30,12,42
06059063702,059,063702,28,0,28
06059063908,059,063908,8,0,8
06059074108,059,074108,30,2,32
06085503110,085,503110,46,0,46
06085503111,085,503111,21,25,46
06085503113,085,503113,53,23,76
06085503213,085,503213,34,21,55
06085503214,085,503214,68,0,68
06085503511,085,503511,13,26,39
06085503602,085,503602,35,16,51
06085504101,085,504101,5,49,54
06059110006,059,110006,18,0,18
06059110014,059,110014,33,0,33
06059110104,059,110104,12,0,12
06059110304,059,110304,24,15,39
06059110607,059,110607,104,23,127
06059099405,059,099405,56,15,71
06059099406,059,099406,30,8,38
06059099412,059,099412,30,0,30
06059099502,059,099502,4,0,4
06059099509,059,099509,0,0,0
06059099514,059,099514,9,10,19
06059099601,059,099601,45,46,91
06059099603,059,099603,42,0,42
06059099703,059,099703,0,10,10
06059099904,059,099904,0,0,0
06059110007,059,110007,23,0,23
06059110108,059,110108,0,21,21
06065042008,065,042008,0,0,0
06065042206,065,042206,47,0,47
06065042208,065,042208,19,0,19
06065042406,065,042406,11,0,11
06065042407,065,042407,0,59,59
06065042506,065,042506,20,88,108
06065042515,065,042515,8,17,25
06065042708,065,042708,42,0,42
06065042904,065,042904,22,0,22
06065043003,065,043003,46,50,96
06065043308,065,043308,9,0,9
06065043312,065,043312,26,0,26
06065043405,065,043405,19,0,19
06065043506,065,043506,6,0,6
06065043701,065,043701,12,15,27
06065042401,065,042401,8,0,8
06065042408,065,042408,7,18,25
06065043206,065,043206,60,15,75
06065043307,065,043307,0,41,41
06037221601,037,221601,17,8,25
06037222001,037,222001,31,4,35
06037234501,037,234501,0,0,0
06037234502,037,234502,29,0,29
06037222002,037,222002,6,33,39
06037226001,037,226001,18,24,42
06037226002,037,226002,0,0,0
06037234901,037,234901,0,0,0
06037234902,037,234902,31,92,123
06037236203,037,236203,0,0,0
06037236204,037,236204,9,0,9
06037237101,037,237101,19,20,39
06037237102,037,237102,12,3,15
06037237201,037,237201,20,9,29
06037237202,037,237202,14,0,14
06037237401,037,237401,0,11,11
06037237402,037,237402,0,15,15
06037239201,037,239201,47,12,59
06037239202,037,239202,0,11,11
06037239501,037,239501,5,16,21
06037239502,037,239502,6,25,31
06037239601,037,239601,31,0,31
06037239602,037,239602,0,9,9
06037239701,037,239701,46,43,89
06037239801,037,239801,14,47,61
06037240401,037,240401,0,55,55
06037239702,037,239702,9,0,9
06037239802,037,239802,9,10,19
06037240402,037,240402,18,0,18
06037241001,037,241001,52,18,70
06037241002,037,241002,8,12,20
06037241201,037,241201,6,0,6
06037241202,037,241202,23,44,67
06001402800,001,402800,14,16,30
06001404400,001,404400,53,0,53
06001400900,001,400900,0,0,0
06001402600,001,402600,6,0,6
06001404200,001,404200,43,6,49
06001405500,001,405500,21,0,21
06001405600,001,405600,22,11,33
06037481800,037,481800,21,0,21
06037482001,037,482001,0,0,0
06037482002,037,482002,22,15,37
06037482522,037,482522,9,0,9
06037500600,037,500600,0,52,52
06037501200,037,501200,40,0,40
06037502200,037,502200,15,0,15
06037502700,037,502700,49,8,57
06037502901,037,502901,0,0,0
06037503801,037,503801,12,7,19
06037503901,037,503901,7,28,35
06037543100,037,543100,0,15,15
06037543202,037,543202,10,39,49
06037543304,037,543304,8,34,42
06037543604,037,543604,21,0,21
06037302002,037,302002,21,7,28
06037503703,037,503703,17,0,17
06059063803,059,063803,75,0,75
06059099249,059,099249,29,0,29
06059062611,059,062611,26,0,26
06059062627,059,062627,0,0,0
06059052511,059,052511,54,0,54
06071006301,071,006301,12,26,38
06059074805,059,074805,37,64,101
06059074901,059,074901,41,44,85
06059075004,059,075004,23,8,31
06059075504,059,075504,44,0,44
06059075506,059,075506,9,0,9
06059075513,059,075513,38,30,68
06059099902,059,099902,27,37,64
06059099903,059,099903,20,0,20
06059110001,059,110001,33,0,33
06059110102,059,110102,45,0,45
06059110109,059,110109,7,0,7
06059110114,059,110114,65,12,77
06059110402,059,110402,58,39,97
06059110500,059,110500,36,50,86
06059042331,059,042331,47,0,47
06067008125,067,008125,92,0,92
06067008134,067,008134,10,0,10
06067006701,067,006701,31,51,82
06067007207,067,007207,5,7,12
06067007413,067,007413,68,94,162
06037408303,037,408303,0,0,0
06037408623,037,408623,18,7,25
06037408625,037,408625,11,0,11
06037408704,037,408704,22,0,22
06037430102,037,430102,17,0,17
06037430701,037,430701,53,0,53
06065045109,065,045109,0,13,13
06065045501,065,045501,23,74,97
06065045703,065,045703,12,46,58
06065940100,065,940100,0,0,0
06065041004,065,041004,53,10,63
06085506801,085,506801,19,0,19
06085507002,085,507002,10,0,10
06085507500,085,507500,7,0,7
06065030101,065,030101,4,0,4
06065030103,065,030103,22,6,28
06065030104,065,030104,14,29,43
06065031601,065,031601,37,28,65
06065040101,065,040101,20,14,34
06065040102,065,040102,19,18,37
06065031602,065,031602,18,13,31
06065040404,065,040404,6,23,29
06065040405,065,040405,25,65,90
06065040609,065,040609,178,11,189
06065040611,065,040611,101,0,101
06065040613,065,040613,42,0,42
06065040607,065,040607,71,0,71
06065040615,065,040615,223,23,246
06065040616,065,040616,63,0,63
06065040812,065,040812,17,6,23
06037573003,037,573003,17,32,49
06037573004,037,573004,0,37,37
06037573601,037,573601,63,0,63
06037576001,037,576001,6,0,6
06037576301,037,576301,30,0,30
06037576302,037,576302,0,0,0
06037576903,037,576903,0,0,0
06037576904,037,576904,0,0,0
06037577504,037,577504,0,0,0
06037577604,037,577604,5,0,5
06071009109,071,009109,95,19,114
06071009108,071,009108,0,52,52
06071009110,071,009110,52,21,73
06071009112,071,009112,22,27,49
06071009114,071,009114,66,0,66
06071009116,071,009116,9,52,61
06071009117,071,009117,6,0,6
06071009118,071,009118,133,55,188
06071009119,071,009119,34,0,34
06071009201,071,009201,18,0,18
06071009202,071,009202,2,0,2
06037207710,037,207710,0,0,0
06037208710,037,208710,19,0,19
06037211310,037,211310,7,21,28
06037212900,037,212900,0,89,89
06037900607,037,900607,10,0,10
06037901003,037,901003,0,0,0
06037901004,037,901004,101,28,129
06037910706,037,910706,16,6,22
06037502302,037,502302,0,0,0
06037920329,037,920329,45,0,45
06037920332,037,920332,0,0,0
06037101400,037,101400,22,12,34
06037104310,037,104310,42,0,42
06037106403,037,106403,0,0,0
06037106520,037,106520,18,9,27
06037571101,037,571101,31,11,42
06037571102,037,571102,27,0,27
06037600304,037,600304,6,30,36
06037600303,037,600303,18,21,39
06037602504,037,602504,32,51,83
06037602505,037,602505,73,57,130
06037602506,037,602506,11,44,55
06037602507,037,602507,11,59,70
06037602508,037,602508,63,92,155
06037602509,037,602509,54,0,54
06067008203,067,008203,38,0,38
06067007202,067,007202,28,0,28
06067007208,067,007208,22,66,88
06067007414,067,007414,0,17,17
06067007415,067,007415,24,0,24
06067007903,067,007903,26,54,80
06067008006,067,008006,28,23,51
06067002400,067,002400,51,0,51
06067003202,067,003202,33,29,62
06073015502,073,015502,12,4,16
06073015601,073,015601,26,26,52
06073016809,073,016809,20,15,35
06073016902,073,016902,15,9,24
06073017018,073,017018,9,0,9
06073017043,073,017043,39,0,39
06073017050,073,017050,3,11,14
06073017303,073,017303,21,0,21
06073017404,073,017404,64,0,64
06073018100,073,018100,30,0,30
06073018300,073,018300,0,0,0
06073018610,073,018610,7,65,72
06073009400,073,009400,18,0,18
06073008512,073,008512,19,0,19
06073000700,073,000700,36,47,83
06073001600,073,001600,0,0,0
06073002707,073,002707,0,0,0
06073011601,073,011601,53,11,64
06073011602,073,011602,20,0,20
06073011801,073,011801,0,45,45
06073012200,073,012200,8,8,16
06073012302,073,012302,0,12,12
06073012800,073,012800,23,0,23
06073013104,073,013104,34,36,70
06073013409,073,013409,8,7,15
06073014001,073,014001,7,25,32
06073014400,073,014400,9,7,16
06073014500,073,014500,40,24,64
06073015000,073,015000,62,18,80
06073010003,073,010003,36,0,36
06073009504,073,009504,0,19,19
06073009801,073,009801,71,0,71
06073009805,073,009805,48,0,48
06073010011,073,010011,16,6,22
06073010014,073,010014,161,39,200
06073010200,073,010200,17,0,17
06073010501,073,010501,0,0,0
06071004504,071,004504,30,12,42
06071005300,071,005300,26,44,70
06071005400,071,005400,0,37,37
06071005500,071,005500,18,11,29
06085505303,085,505303,55,0,55
06071001307,071,001307,4,11,15
06071001308,071,001308,0,27,27
06071001309,071,001309,0,58,58
06071001310,071,001310,0,0,0
06071001311,071,001311,13,12,25
06071001312,071,001312,37,0,37
06071001501,071,001501,6,10,16
06071001503,071,001503,19,14,33
06071001504,071,001504,52,51,103
06071001704,071,001704,0,48,48
06071001706,071,001706,53,94,147
06071001707,071,001707,63,15,78
06071001804,071,001804,0,40,40
06071001806,071,001806,57,0,57
06071001808,071,001808,56,9,65
06071001810,071,001810,22,28,50
06071001809,071,001809,0,45,45
06071001812,071,001812,11,2,13
06071001901,071,001901,15,0,15
06071001903,071,001903,57,21,78
06071001905,071,001905,95,25,120
06071001813,071,001813,37,0,37
06071001906,071,001906,0,17,17
06071002011,071,002011,16,0,16
06071002013,071,002013,24,16,40
06071002014,071,002014,35,0,35
06071002015,071,002015,60,9,69
06071002016,071,002016,24,18,42
06071002017,071,002017,19,0,19
06001451703,001,451703,37,0,37
06001451704,001,451704,35,27,62
06001981900,001,981900,0,0,0
06037920030,037,920030,45,52,97
06037910805,037,910805,0,8,8
06037910809,037,910809,4,0,4
06037535606,037,535606,4,0,4
06037534202,037,534202,0,8,8
06037534900,037,534900,15,26,41
06037535102,037,535102,25,0,25
06037535701,037,535701,35,28,63
06037536000,037,536000,11,0,11
06037536102,037,536102,0,0,0
06037536200,037,536200,20,59,79
06037540400,037,540400,0,0,0
06037107010,037,107010,0,0,0
06037108101,037,108101,21,4,25
06037109300,037,109300,12,0,12
06037109400,037,109400,0,0,0
06073010601,073,010601,6,0,6
06073017036,073,017036,7,0,7
06073016616,073,016616,0,11,11
06073016701,073,016701,16,25,41
06073017035,073,017035,0,0,0
06073017046,073,017046,28,0,28
06073017049,073,017049,19,15,34
06073017306,073,017306,0,0,0
06073017702,073,017702,18,0,18
06073017801,073,017801,11,0,11
06073017810,073,017810,38,0,38
06037113322,037,113322,0,10,10
06037113421,037,113421,34,25,59
06037117301,037,117301,10,0,10
06037117404,037,117404,9,24,33
06037121010,037,121010,13,0,13
06037121600,037,121600,28,4,32
06037231600,037,231600,55,20,75
06037224410,037,224410,0,0,0
06037226420,037,226420,0,0,0
06037228710,037,228710,0,0,0
06037232500,037,232500,0,33,33
06037620301,037,620301,59,0,59
06037620522,037,620522,21,0,21
06037117520,037,117520,28,10,38
06037106643,037,106643,64,0,64
06037109100,037,109100,4,9,13
06037109800,037,109800,41,11,52
06037111204,037,111204,11,12,23
06037113401,037,113401,21,0,21
06037115301,037,115301,44,0,44
06037117405,037,117405,0,14,14
06037119320,037,119320,13,0,13
06037120030,037,120030,21,0,21
06037121020,037,121020,15,7,22
06037122000,037,122000,38,25,63
06037123020,037,123020,6,8,14
06037123800,037,123800,41,0,41
06037124000,037,124000,29,27,56
06037124300,037,124300,8,0,8
06037124500,037,124500,18,8,26
06037125100,037,125100,134,0,134
06037127220,037,127220,9,0,9
06037554518,037,554518,10,0,10
06037552400,037,552400,13,11,24
06037552602,037,552602,13,0,13
06037552700,037,552700,43,0,43
06037554700,037,554700,12,7,19
06037109500,037,109500,39,0,39
06037111202,037,111202,8,0,8
06037111301,037,111301,17,0,17
06037115101,037,115101,0,0,0
06037119340,037,119340,0,21,21
06037120400,037,120400,16,34,50
06037123203,037,123203,0,0,0
06037123602,037,123602,16,0,16
06037124400,037,124400,54,0,54
06037127400,037,127400,18,66,84
06037128500,037,128500,59,0,59
06037131800,037,131800,44,0,44
06037134304,037,134304,18,0,18
06037134306,037,134306,0,0,0
06037135102,037,135102,25,0,25
06037135203,037,135203,0,0,0
06037139301,037,139301,0,0,0
06085505401,085,505401,0,0,0
06085505900,085,505900,16,0,16
06085506604,085,506604,48,16,64
06085507100,085,507100,24,0,24
06085507203,085,507203,9,0,9
06085507205,085,507205,47,0,47
06085507206,085,507206,19,0,19
06085507402,085,507402,35,0,35
06085508304,085,508304,27,0,27
06085508404,085,508404,48,14,62
06085509106,085,509106,26,0,26
06085509600,085,509600,47,0,47
06085510802,085,510802,0,0,0
06085511100,085,511100,11,0,11
06085511200,085,511200,21,0,21
06085512001,085,512001,61,14,75
06085501000,085,501000,18,0,18
06085501502,085,501502,30,9,39
06085502800,085,502800,10,0,10
06085502908,085,502908,65,0,65
06085503003,085,503003,46,0,46
06085503212,085,503212,28,0,28
06085503218,085,503218,20,0,20
06085503313,085,503313,45,9,54
06067008913,067,008913,0,0,0
06067009005,067,009005,0,0,0
06037141304,037,141304,16,0,16
06037143604,037,143604,0,0,0
06037183103,037,183103,34,10,44
06037143603,037,143603,10,0,10
06037183221,037,183221,8,24,32
06037183104,037,183104,7,12,19
06037183222,037,183222,11,0,11
06037183401,037,183401,8,0,8
06037408722,037,408722,14,0,14
06037533202,037,533202,0,0,0
06037534404,037,534404,13,38,51
06037541700,037,541700,8,52,60
06037543400,037,543400,13,0,13
06037143200,037,143200,0,0,0
06037128400,037,128400,52,0,52
06037294900,037,294900,0,24,24
06037300200,037,300200,8,0,8
06037218110,037,218110,0,0,0
06037219500,037,219500,21,0,21
06037226700,037,226700,15,45,60
06037231100,037,231100,7,24,31
06037235201,037,235201,9,17,26
06037502402,037,502402,18,13,31
06037461502,037,461502,37,47,84
06037461901,037,461901,14,30,44
06037461902,037,461902,0,0,0
06037462001,037,462001,9,24,33
06037462002,037,462002,32,0,32
06037462201,037,462201,0,0,0
06037462202,037,462202,16,0,16
06037462301,037,462301,0,42,42
06037462302,037,462302,30,0,30
06037463601,037,463601,30,20,50
06037463602,037,463602,72,74,146
06037480303,037,480303,11,0,11
06037481605,037,481605,33,12,45
06037481606,037,481606,9,0,9
06037500403,037,500403,0,0,0
06037500404,037,500404,6,0,6
06037501001,037,501001,29,0,29
06037501803,037,501803,19,9,28
06037501804,037,501804,0,6,6
06037480304,037,480304,13,0,13
06037501002,037,501002,47,7,54
06037502003,037,502003,4,0,4
06037502004,037,502004,3,0,3
06065031702,065,031702,14,0,14
06065046403,065,046403,25,18,43
06065045110,065,045110,26,10,36
06001425102,001,425102,9,0,9
06001425103,001,425103,0,0,0
06001430101,001,430101,76,23,99
06001430102,001,430102,12,0,12
06001425104,001,425104,30,0,30
06001428700,001,428700,23,0,23
06001432501,001,432501,11,0,11
06001442400,001,442400,20,0,20
06001444200,001,444200,31,9,40
06001450604,001,450604,22,0,22
06001450701,001,450701,56,0,56
06001435800,001,435800,84,0,84
06001435900,001,435900,73,0,73
06001436500,001,436500,11,50,61
06001436700,001,436700,7,0,7
06037701304,037,701304,70,0,70
06037701402,037,701402,14,0,14
06037701902,037,701902,0,0,0
06037702002,037,702002,43,37,80
06037702102,037,702102,32,0,32
06037800203,037,800203,36,0,36
06037800204,037,800204,57,0,57
06037800327,037,800327,43,0,43
06037800328,037,800328,9,25,34
06037800329,037,800329,27,0,27
06065043821,065,043821,75,16,91
06065043822,065,043822,20,0,20
06065043823,065,043823,116,40,156
06065044930,065,044930,0,0,0
06065044931,065,044931,14,0,14
06065044932,065,044932,36,0,36
06059099232,059,099232,34,16,50
06059099237,059,099237,56,0,56
06059099239,059,099239,10,14,24
06059099247,059,099247,7,17,24
06059021830,059,021830,25,0,25
06065044404,065,044404,10,0,10
06065044405,065,044405,0,0,0
06065044515,065,044515,0,0,0
06065044516,065,044516,22,0,22
06065043309,065,043309,27,33,60
06065043311,065,043311,13,19,32
06065043404,065,043404,0,0,0
06065030700,065,030700,0,20,20
06065031300,065,031300,0,6,6
06085511701,085,511701,0,0,0
06085512005,085,512005,45,0,45
06085512100,085,512100,0,0,0
06071000301,071,000301,32,18,50
06071002502,071,002502,36,30,66
06071004201,071,004201,10,0,10
06059011504,059,011504,78,0,78
06059011709,059,011709,41,0,41
06059011714,059,011714,6,0,6
06059021810,059,021810,12,0,12
06059021817,059,021817,0,0,0
06059021921,059,021921,37,0,37
06059032002,059,032002,23,0,23
06065044517,065,044517,14,0,14
06065044518,065,044518,22,32,54
06065044520,065,044520,0,37,37
06065044521,065,044521,0,0,0
06065044522,065,044522,6,5,11
06065044605,065,044605,21,0,21
06065044606,065,044606,0,60,60
06065044917,065,044917,0,0,0
06065044918,065,044918,0,0,0
06065044919,065,044919,35,0,35
06065044921,065,044921,0,0,0
06065044922,065,044922,75,0,75
06065044923,065,044923,26,14,40
06065044924,065,044924,21,0,21
06065044925,065,044925,36,4,40
06065044926,065,044926,51,21,72
06065044927,065,044927,0,43,43
06065044928,065,044928,0,0,0
06065044929,065,044929,17,29,46
06037407001,037,407001,43,33,76
06037480804,037,480804,8,39,47
06037463101,037,463101,16,7,23
06037480102,037,480102,0,0,0
06037480302,037,480302,44,0,44
06037481001,037,481001,20,0,20
06037481500,037,481500,0,0,0
06037481604,037,481604,7,0,7
06037481711,037,481711,16,33,49
06037481901,037,481901,33,0,33
06037482101,037,482101,9,0,9
06037482201,037,482201,28,0,28
06037482202,037,482202,16,0,16
06037482503,037,482503,33,0,33
06037482701,037,482701,14,0,14
06037500402,037,500402,39,8,47
06071006201,071,006201,7,12,19
06071007407,071,007407,0,49,49
06071010415,071,010415,11,0,11
06071011900,071,011900,69,13,82
06071007302,071,007302,0,0,0
06037535001,037,535001,36,24,60
06037535002,037,535002,0,0,0
06037536103,037,536103,22,0,22
06037536104,037,536104,31,39,70
06037542103,037,542103,7,27,34
06037542104,037,542104,24,9,33
06037542105,037,542105,0,0,0
06037542106,037,542106,5,0,5
06037543306,037,543306,88,0,88
06037550201,037,550201,34,0,34
06037550202,037,550202,37,9,46
06037543905,037,543905,10,65,75
06037544001,037,544001,0,0,0
06037544002,037,544002,13,0,13
06037550601,037,550601,36,27,63
06037550602,037,550602,0,11,11
06037550901,037,550901,18,27,45
06037550902,037,550902,17,48,65
06037551101,037,551101,41,0,41
06037551102,037,551102,31,18,49
06037551401,037,551401,0,42,42
06037551402,037,551402,14,40,54
06037551501,037,551501,11,7,18
06037551502,037,551502,13,10,23
06037552001,037,552001,14,0,14
06037552002,037,552002,8,15,23
06037552301,037,552301,12,0,12
06037552302,037,552302,15,30,45
06037553503,037,553503,13,57,70
06037553504,037,553504,8,58,66
06037554103,037,554103,16,12,28
06037554104,037,554104,3,5,8
06037554105,037,554105,0,0,0
06037554203,037,554203,0,42,42
06037554204,037,554204,0,0,0
06037554301,037,554301,0,0,0
06037502100,037,502100,8,78,86
06037503302,037,503302,77,0,77
06037101210,037,101210,17,16,33
06037106010,037,106010,0,0,0
06037106020,037,106020,13,0,13
06037106111,037,106111,38,63,101
06037106114,037,106114,0,19,19
06037106642,037,106642,6,0,6
06071008200,071,008200,55,0,55
06071009710,071,009710,0,22,22
06071010412,071,010412,43,64,107
06085512017,085,512017,53,10,63
06085512031,085,512031,17,0,17
06085512309,085,512309,0,0,0
06085500600,085,500600,26,0,26
06037431001,037,431001,18,0,18
06037432202,037,432202,70,8,78
06037432602,037,432602,11,0,11
06037432802,037,432802,18,0,18
06037433601,037,433601,0,0,0
06037461600,037,461600,39,0,39
06037462800,037,462800,46,0,46
06037670500,037,670500,4,0,4
06037701202,037,701202,51,9,60
06037702300,037,702300,18,0,18
06037703002,037,703002,15,25,40
06037800202,037,800202,14,0,14
06037900300,037,900300,11,4,15
06037910709,037,910709,0,0,0
06037572900,037,572900,9,43,52
06037573700,037,573700,33,0,33
06037574500,037,574500,130,0,130
06037533502,037,533502,8,6,14
06037533503,037,533503,10,12,22
06037533701,037,533701,0,0,0
06037534002,037,534002,10,2,12
06037534102,037,534102,0,58,58
06037535605,037,535605,0,25,25
06037540203,037,540203,0,0,0
06037541002,037,541002,0,28,28
06037541802,037,541802,0,0,0
06037543000,037,543000,0,13,13
06037113211,037,113211,32,0,32
06037504101,037,504101,33,22,55
06037530005,037,530005,9,0,9
06037530204,037,530204,0,19,19
06037113234,037,113234,18,23,41
06037115201,037,115201,59,0,59
06037408629,037,408629,12,0,12
06037430724,037,430724,0,24,24
06037431100,037,431100,53,0,53
06037432300,037,432300,71,16,87
06037432401,037,432401,0,16,16
06037433200,037,433200,0,15,15
06037460100,037,460100,0,0,0
06037533402,037,533402,14,12,26
06037531603,037,531603,9,0,9
06037502005,037,502005,21,9,30
06037502801,037,502801,43,45,88
06037502802,037,502802,0,12,12
06037503103,037,503103,27,8,35
06037503104,037,503104,27,0,27
06037503105,037,503105,8,4,12
06037503106,037,503106,32,0,32
06037531503,037,531503,0,47,47
06037531504,037,531504,121,12,133
06037533001,037,533001,0,61,61
06037533002,037,533002,22,0,22
06037533805,037,533805,10,7,17
06037533806,037,533806,0,23,23
06071008401,071,008401,17,17,34
06071008703,071,008703,48,0,48
06071007403,071,007403,61,66,127
06071006500,071,006500,29,94,123
06071007106,071,007106,30,0,30
06071007200,071,007200,21,20,41
06071007601,071,007601,30,16,46
06071007800,071,007800,21,18,39
06071008100,071,008100,39,13,52
06071008800,071,008800,0,43,43
06071009800,071,009800,11,0,11
06071010009,071,010009,10,19,29
06071010010,071,010010,43,19,62
06071010013,071,010013,15,17,32
06071010020,071,010020,115,0,115
06071010413,071,010413,0,0,0
06071010416,071,010416,16,0,16
06071010802,071,010802,0,0,0
06071011600,071,011600,0,44,44
06071940100,071,940100,7,0,7
06071000108,071,000108,60,0,60
06037504001,037,504001,46,0,46
06037530006,037,530006,13,13,26
06037530202,037,530202,16,0,16
06037530601,037,530601,5,4,9
06037531102,037,531102,13,0,13
06037531602,037,531602,39,0,39
06037531702,037,531702,18,0,18
06037531902,037,531902,0,0,0
06037532200,037,532200,0,0,0
06037532303,037,532303,13,10,23
06037532700,037,532700,10,21,31
06037533103,037,533103,0,0,0
06037533203,037,533203,0,4,4
06037533602,037,533602,32,20,52
06037535400,037,535400,5,0,5
06037535607,037,535607,36,19,55
06037540101,037,540101,11,71,82
06071000118,071,000118,7,21,28
06071000203,071,000203,0,12,12
06071000403,071,000403,0,26,26
06071000205,071,000205,0,25,25
06071000207,071,000207,0,17,17
06071000208,071,000208,23,22,45
06071000404,071,000404,8,11,19
06071000501,071,000501,40,0,40
06071000503,071,000503,10,0,10
06071000504,071,000504,7,10,17
06071000603,071,000603,44,33,77
06071000604,071,000604,48,47,95
06071000804,071,000804,12,0,12
06071001702,071,001702,42,32,74
06071000605,071,000605,0,0,0
06071000606,071,000606,52,37,89
06071000813,071,000813,0,0,0
06071000815,071,000815,12,0,12
06071000816,071,000816,8,0,8
06071000817,071,000817,47,0,47
06071000814,071,000814,0,0,0
06071000818,071,000818,25,20,45
06071000819,071,000819,26,0,26
06071000820,071,000820,16,0,16
06071000821,071,000821,23,8,31
06037431700,037,431700,43,0,43
06037432700,037,432700,31,0,31
06037433902,037,433902,6,0,6
06037434001,037,434001,0,14,14
06037460301,037,460301,39,38,77
06037460800,037,460800,16,0,16
06037461200,037,461200,0,0,0
06037462700,037,462700,66,28,94
06037463200,037,463200,0,0,0
06037463800,037,463800,12,17,29
06037464000,037,464000,36,0,36
06037430501,037,430501,14,0,14
06037430801,037,430801,31,0,31
06037430803,037,430803,38,0,38
06037431002,037,431002,28,0,28
06037431300,037,431300,57,0,57
06037432601,037,432601,39,11,50
06037433302,037,433302,0,7,7
06037433501,037,433501,0,0,0
06037460200,037,460200,0,0,0
06037101220,037,101220,0,24,24
06037103400,037,103400,0,0,0
06037104105,037,104105,53,0,53
06037540201,037,540201,6,17,23
06037218220,037,218220,38,0,38
06037222200,037,222200,20,0,20
06037228100,037,228100,19,69,88
06037232400,037,232400,23,87,110
06037241300,037,241300,12,44,56
06037481103,037,481103,21,0,21
06037500100,037,500100,0,0,0
06037920038,037,920038,0,24,24
06071000823,071,000823,37,153,190
06071000824,071,000824,0,49,49
06071000825,071,000825,16,27,43
06037570301,037,570301,0,49,49
06037604100,037,604100,15,47,62
06037573800,037,573800,41,0,41
06037576801,037,576801,14,27,41
06037601212,037,601212,76,41,117
06037650702,037,650702,59,0,59
06037106604,037,106604,14,4,18
06037113321,037,113321,19,0,19
06037541100,037,541100,0,37,37
06037542800,037,542800,0,17,17
06037550300,037,550300,43,19,62
06037553802,037,553802,9,40,49
06037555102,037,555102,19,29,48
06037275603,037,275603,0,0,0
06037278001,037,278001,7,0,7
06037278102,037,278102,10,0,10
06037293306,037,293306,11,0,11
06037293307,037,293307,14,0,14
06037294301,037,294301,9,0,9
06037294701,037,294701,5,26,31
06037294302,037,294302,11,15,26
06037294421,037,294421,0,0,0
06037295103,037,295103,79,0,79
06037296401,037,296401,0,0,0
06037296402,037,296402,0,0,0
06037296901,037,296901,0,64,64
06037296902,037,296902,18,45,63
06037297201,037,297201,49,0,49
06037480002,037,480002,8,0,8
06037500700,037,500700,0,51,51
06037670405,037,670405,0,0,0
06037601302,037,601302,29,59,88
06037602404,037,602404,23,8,31
06059032061,059,032061,0,0,0
06059062648,059,062648,0,0,0
06059062649,059,062649,0,16,16
06059087505,059,087505,0,16,16
06059980000,059,980000,0,0,0
06059990100,059,990100,0,0,0
06037297202,037,297202,0,28,28
06037301206,037,301206,10,0,10
06037297601,037,297601,44,0,44
06037297602,037,297602,0,0,0
06037300301,037,300301,0,0,0
06037301205,037,301205,0,0,0
06037301801,037,301801,29,16,45
06037301802,037,301802,62,10,72
06037302003,037,302003,8,0,8
06037302004,037,302004,21,0,21
06037302401,037,302401,11,33,44
06037302503,037,302503,63,10,73
06073010401,073,010401,4,9,13
06073010900,073,010900,7,0,7
06073013306,073,013306,0,0,0
06073013505,073,013505,28,0,28
06073013701,073,013701,0,0,0
06073013908,073,013908,0,17,17
06073016608,073,016608,0,17,17
06073016804,073,016804,32,0,32
06073017009,073,017009,36,0,36
06073017015,073,017015,47,84,131
06073010800,073,010800,13,0,13
06073011700,073,011700,20,0,20
06073012102,073,012102,6,18,24
06073012303,073,012303,0,0,0
06073012600,073,012600,42,19,61
06073013103,073,013103,30,0,30
06073013311,073,013311,192,0,192
06073013412,073,013412,22,0,22
06073013414,073,013414,20,19,39
06059075403,059,075403,47,9,56
06059042107,059,042107,6,0,6
06059001101,059,001101,15,10,25
06059001601,059,001601,28,0,28
06037208802,037,208802,13,24,37
06037209103,037,209103,10,11,21
06037209104,037,209104,0,0,0
06037211121,037,211121,24,14,38
06037211122,037,211122,0,58,58
06037211201,037,211201,6,21,27
06037211202,037,211202,0,0,0
06037211703,037,211703,0,20,20
06037211704,037,211704,28,0,28
06037211803,037,211803,19,9,28
06037211804,037,211804,0,0,0
06037211921,037,211921,0,0,0
06037211922,037,211922,54,32,86
06037212101,037,212101,0,9,9
06037212102,037,212102,21,30,51
06037212501,037,212501,0,0,0
06085508001,085,508001,36,0,36
06085510001,085,510001,38,0,38
06085506000,085,506000,54,29,83
06085510400,085,510400,7,0,7
06085508303,085,508303,19,0,19
06085511905,085,511905,37,0,37
06085512308,085,512308,14,0,14
06073007701,073,007701,0,0,0
06073007702,073,007702,15,0,15
06073007907,073,007907,30,13,43
06073000201,073,000201,0,0,0
06073007905,073,007905,0,0,0
06073002711,073,002711,53,14,67
06073003304,073,003304,31,14,45
06073007908,073,007908,21,0,21
06073007910,073,007910,18,0,18
06073008363,073,008363,40,0,40
06073008364,073,008364,40,0,40
06073008003,073,008003,21,0,21
06073008006,073,008006,58,0,58
06073008361,073,008361,19,0,19
06073008362,073,008362,31,0,31
06073008365,073,008365,25,6,31
06073008366,073,008366,11,0,11
06073009305,073,009305,33,15,48
06073009306,073,009306,111,17,128
06073009510,073,009510,74,0,74
06073009511,073,009511,43,0,43
06073012501,073,012501,7,7,14
06073012502,073,012502,27,21,48
06073014805,073,014805,8,0,8
06073014806,073,014806,0,19,19
06073014902,073,014902,25,0,25
06037603301,037,603301,41,7,48
06037603302,037,603302,0,0,0
06037603702,037,603702,0,0,0
06085503211,085,503211,52,0,52
06085503326,085,503326,60,8,68
06085504417,085,504417,0,0,0
06085503115,085,503115,46,64,110
06085503509,085,503509,17,0,17
06085504320,085,504320,41,0,41
06085505500,085,505500,13,12,25
06085507905,085,507905,10,0,10
06085511000,085,511000,0,15,15
06037620102,037,620102,57,6,63
06037620521,037,620521,31,8,39
06037620602,037,620602,83,0,83
06037650701,037,650701,6,5,11
06037651302,037,651302,63,0,63
06037670002,037,670002,0,0,0
06067004701,067,004701,39,29,68
06067004702,067,004702,10,104,114
06067003203,067,003203,17,0,17
06067005204,067,005204,57,8,65
06067005301,067,005301,0,26,26
06067005509,067,005509,8,16,24
06067005510,067,005510,13,53,66
06067005903,067,005903,29,17,46
06067005904,067,005904,0,10,10
06067005205,067,005205,0,0,0
06067007015,067,007015,24,29,53
06067007016,067,007016,37,32,69
06067007017,067,007017,21,0,21
06067007018,067,007018,102,0,102
06037232300,037,232300,48,18,66
06037235100,037,235100,80,12,92
06037237710,037,237710,16,62,78
06037238100,037,238100,0,0,0
06037240020,037,240020,10,16,26
06037241110,037,241110,13,0,13
06073017021,073,017021,0,0,0
06073017034,073,017034,59,0,59
06073017041,073,017041,28,0,28
06037221500,037,221500,0,9,9
06037221710,037,221710,5,14,19
06037226410,037,226410,20,31,51
06037228600,037,228600,0,0,0
06037232110,037,232110,16,0,16
06037232200,037,232200,8,0,8
06037234800,037,234800,0,0,0
06037236000,037,236000,0,0,0
06037238200,037,238200,25,0,25
06037239330,037,239330,5,8,13
06037240200,037,240200,0,8,8
06037132900,037,132900,36,0,36
06037133100,037,133100,0,0,0
06037134104,037,134104,33,0,33
06037212305,037,212305,11,7,18
06037212620,037,212620,9,0,9
06037213320,037,213320,0,0,0
06037214700,037,214700,0,0,0
06037216800,037,216800,37,11,48
06037217200,037,217200,26,0,26
06037221810,037,221810,0,0,0
06037222100,037,222100,0,14,14
06037224700,037,224700,0,0,0
06065045302,065,045302,0,25,25
06065045706,065,045706,0,23,23
06065046101,065,046101,14,0,14
06065046200,065,046200,0,46,46
06065044000,065,044000,10,0,10
06065040904,065,040904,27,40,67
06065040606,065,040606,27,0,27
06065040703,065,040703,0,0,0
06065041407,065,041407,7,18,25
06071009904,071,009904,66,106,172
06071009905,071,009905,96,74,170
06037106407,037,106407,1,29,30
06037106408,037,106408,28,29,57
06037106645,037,106645,9,54,63
06037106646,037,106646,10,0,10
06037106648,037,106648,5,19,24
06037106649,037,106649,8,8,16
06037108201,037,108201,22,0,22
06037108202,037,108202,102,55,157
06037109603,037,109603,14,0,14
06037109604,037,109604,32,7,39
06037111205,037,111205,6,0,6
06037111206,037,111206,0,7,7
06037113101,037,113101,25,0,25
06037113102,037,113102,32,0,32
06037141400,037,141400,24,0,24
06037141500,037,141500,20,0,20
06037123304,037,123304,0,0,0
06037296600,037,296600,30,0,30
06037297500,037,297500,12,16,28
06037300400,037,300400,0,0,0
06037265510,037,265510,9,0,9
06073019806,073,019806,74,145,219
06073019701,073,019701,47,0,47
06059076205,059,076205,60,27,87
06059086802,059,086802,13,52,65
06059088203,059,088203,7,0,7
06059088302,059,088302,12,18,30
06059088701,059,088701,23,13,36
06059075303,059,075303,44,11,55
06059074806,059,074806,19,44,63
06059075003,059,075003,14,7,21
06059075401,059,075401,20,0,20
06059075404,059,075404,30,12,42
06059075514,059,075514,16,5,21
06059075606,059,075606,22,0,22
06059086301,059,086301,26,57,83
06059086303,059,086303,11,0,11
06059086406,059,086406,23,0,23
06037113235,037,113235,13,0,13
06037113237,037,113237,0,17,17
06037115103,037,115103,0,0,0
06037115104,037,115104,0,0,0
06037117201,037,117201,27,20,47
06037115403,037,115403,58,0,58
06037115404,037,115404,66,0,66
06037117101,037,117101,32,73,105
06037117102,037,117102,7,0,7
06037117407,037,117407,4,14,18
06037117408,037,117408,29,19,48
06037117202,037,117202,27,0,27
06037119001,037,119001,16,10,26
06037119002,037,119002,47,49,96
06037119201,037,119201,24,0,24
06037119202,037,119202,23,0,23
06037119341,037,119341,3,10,13
06037119342,037,119342,0,20,20
06059062622,059,062622,0,0,0
06059062634,059,062634,34,0,34
06059062637,059,062637,0,0,0
06059062638,059,062638,189,0,189
06059062639,059,062639,34,29,63
06059062630,059,062630,6,0,6
06059052520,059,052520,23,0,23
06059052527,059,052527,81,18,99
06059052528,059,052528,0,0,0
06059062642,059,062642,0,0,0
06059063006,059,063006,0,0,0
06059063202,059,063202,21,0,21
06059063604,059,063604,52,6,58
06059063904,059,063904,52,6,58
06059074006,059,074006,34,33,67
06059075603,059,075603,12,5,17
06059075816,059,075816,14,43,57
06059086402,059,086402,24,16,40
06059087405,059,087405,26,33,59
06059087503,059,087503,84,19,103
06059087805,059,087805,68,0,68
06059087902,059,087902,37,15,52
06059088101,059,088101,34,0,34
06059088105,059,088105,24,0,24
06059089107,059,089107,16,0,16
06059087103,059,087103,50,14,64
06059087601,059,087601,0,0,0
06059087802,059,087802,36,24,60
06059088502,059,088502,0,9,9
06059088702,059,088702,0,11,11
06059089102,059,089102,45,15,60
06059089104,059,089104,9,18,27
06059089106,059,089106,59,0,59
06059099202,059,099202,95,46,141
06059099212,059,099212,9,26,35
06059099223,059,099223,21,0,21
06059099227,059,099227,26,23,49
06059099230,059,099230,10,0,10
06059099244,059,099244,0,0,0
06059099416,059,099416,0,25,25
06059099506,059,099506,0,5,5
06065044701,065,044701,0,0,0
06065044702,065,044702,0,7,7
06065044904,065,044904,27,0,27
06065045207,065,045207,25,28,53
06067009007,067,009007,55,0,55
06067009110,067,009110,34,12,46
06067009314,067,009314,73,0,73
06067009404,067,009404,11,23,34
06067009501,067,009501,10,10,20
06067009606,067,009606,17,58,75
06067009608,067,009608,0,23,23
06067009615,067,009615,0,0,0
06067003502,067,003502,15,0,15
06067004201,067,004201,35,32,67
06067004401,067,004401,11,19,30
06067004602,067,004602,11,30,41
06067005201,067,005201,0,0,0
06067005508,067,005508,11,0,11
06067005605,067,005605,0,9,9
06067005901,067,005901,41,33,74
06067001500,067,001500,86,18,104
06067009312,067,009312,66,0,66
06067009316,067,009316,6,21,27
06067009503,067,009503,0,0,0
06067009601,067,009601,45,35,80
06067009612,067,009612,23,80,103
06067005804,067,005804,13,0,13
06059099204,059,099204,29,0,29
06059099214,059,099214,10,0,10
06059086306,059,086306,8,18,26
06059086407,059,086407,16,46,62
06059086501,059,086501,3,0,3
06059087001,059,087001,17,0,17
06059087102,059,087102,18,23,41
06059087106,059,087106,27,0,27
06059087300,059,087300,30,0,30
06059087703,059,087703,24,0,24
06037602801,037,602801,26,28,54
06037602802,037,602802,20,0,20
06037603005,037,603005,27,31,58
06037603006,037,603006,9,0,9
06037702400,037,702400,0,0,0
06037702502,037,702502,23,0,23
06037800102,037,800102,31,0,31
06067006002,067,006002,34,0,34
06067006202,067,006202,0,0,0
06067006702,067,006702,65,23,88
06067001600,067,001600,61,0,61
06067002300,067,002300,16,8,24
06067003102,067,003102,36,0,36
06067003501,067,003501,0,7,7
06067003700,067,003700,11,30,41
06059062619,059,062619,15,0,15
06059062621,059,062621,131,0,131
06037503902,037,503902,9,0,9
06037531701,037,531701,26,0,26
06037301900,037,301900,89,0,89
06037400603,037,400603,63,0,63
06037403402,037,403402,9,0,9
06037404401,037,404401,23,0,23
06037407102,037,407102,39,31,70
06037201110,037,201110,14,14,28
06037209810,037,209810,32,11,43
06037212410,037,212410,18,0,18
06037910501,037,910501,0,19,19
06037920106,037,920106,5,31,36
06037401001,037,401001,0,0,0
06037292000,037,292000,7,37,44
06037620701,037,620701,42,0,42
06037621102,037,621102,0,13,13
06037621301,037,621301,46,0,46
06037650200,037,650200,5,0,5
06037650300,037,650300,16,0,16
06037670001,037,670001,8,0,8
06071002018,071,002018,44,0,44
06071002019,071,002019,7,33,40
06037701302,037,701302,20,0,20
06037701602,037,701602,49,0,49
06037701802,037,701802,11,0,11
06037702202,037,702202,41,0,41
06073018904,073,018904,39,49,88
06073019105,073,019105,0,0,0
06073019207,073,019207,16,29,45
06073000300,073,000300,19,0,19
06073000800,073,000800,98,0,98
06073002201,073,002201,0,0,0
06073009802,073,009802,31,0,31
06073017033,073,017033,36,12,48
06073017304,073,017304,103,0,103
06073018608,073,018608,28,0,28
06073017010,073,017010,4,10,14
06073021202,073,021202,2,1,3
06073019302,073,019302,74,0,74
06073020103,073,020103,114,0,114
06073020801,073,020801,13,16,29
06073002801,073,002801,6,11,17
06059032014,059,032014,0,33,33
06059032037,059,032037,0,0,0
06059032044,059,032044,13,0,13
06001423400,001,423400,0,12,12
06001423901,001,423901,12,0,12
06001423902,001,423902,6,0,6
06001427200,001,427200,7,0,7
06001428500,001,428500,26,0,26
06001430400,001,430400,11,0,11
06001431100,001,431100,53,0,53
06001433500,001,433500,33,18,51
06001433900,001,433900,0,0,0
06037403319,037,403319,22,0,22
06037403408,037,403408,0,0,0
06037404902,037,404902,21,5,26
06037405203,037,405203,5,0,5
06037405400,037,405400,55,22,77
06037406102,037,406102,25,13,38
06037406500,037,406500,28,0,28
06037407900,037,407900,34,68,102
06037408628,037,408628,6,0,6
06037408705,037,408705,21,0,21
06037408800,037,408800,0,7,7
06037123204,037,123204,0,0,0
06037108103,037,108103,35,0,35
06037242300,037,242300,0,41,41
06037407701,037,407701,0,0,0
06037406200,037,406200,0,34,34
06037461300,037,461300,17,54,71
06037575802,037,575802,40,56,96
06037183610,037,183610,0,7,7
06037574602,037,574602,0,0,0
06037575402,037,575402,6,19,25
06037576602,037,576602,38,37,75
06085504316,085,504316,22,0,22
06085504321,085,504321,73,7,80
06085504505,085,504505,57,55,112
06085504803,085,504803,124,82,206
06085505203,085,505203,40,0,40
06085505403,085,505403,0,3,3
06085506102,085,506102,24,0,24
06085507600,085,507600,26,0,26
06085507701,085,507701,5,24,29
06085507808,085,507808,51,0,51
06037270100,037,270100,40,0,40
06037276000,037,276000,43,0,43
06037291210,037,291210,15,7,22
06037293202,037,293202,32,42,74
06037576402,037,576402,10,0,10
06037576700,037,576700,25,12,37
06037430101,037,430101,27,0,27
06037430200,037,430200,0,0,0
06037430400,037,430400,7,0,7
06037431400,037,431400,21,8,29
06037533603,037,533603,0,27,27
06037533902,037,533902,0,28,28
06037534203,037,534203,32,12,44
06037534405,037,534405,6,13,19
06037534501,037,534501,16,11,27
06037534700,037,534700,11,4,15
06037535501,037,535501,22,17,39
06037535804,037,535804,10,41,51
06037540202,037,540202,37,25,62
06037540300,037,540300,53,21,74
06037540501,037,540501,35,0,35
06037541001,037,541001,5,4,9
06037542502,037,542502,21,44,65
06037542601,037,542601,4,0,4
06037542602,037,542602,22,0,22
06037543322,037,543322,0,31,31
06037543503,037,543503,21,56,77
06059087803,059,087803,58,0,58
06059088104,059,088104,16,40,56
06059088403,059,088403,25,0,25
06059088602,059,088602,0,21,21
06059088801,059,088801,67,19,86
06059088802,059,088802,7,0,7
06059089003,059,089003,17,8,25
06059089004,059,089004,45,32,77
06059089105,059,089105,28,33,61
06059099222,059,099222,45,0,45
06059099229,059,099229,0,0,0
06059099246,059,099246,26,0,26
06059099251,059,099251,22,0,22
06059099308,059,099308,26,0,26
06059099411,059,099411,31,0,31
06059099413,059,099413,44,0,44
06059099415,059,099415,79,0,79
06059099417,059,099417,16,15,31
06059099508,059,099508,36,0,36
06059099511,059,099511,0,0,0
06059062900,059,062900,0,0,0
06059099203,059,099203,32,0,32
06059099216,059,099216,7,0,7
06059099225,059,099225,34,3,37
06037194300,037,194300,17,0,17
06037209403,037,209403,0,0,0
06037209520,037,209520,5,24,29
06037553200,037,553200,21,0,21
06037553502,037,553502,10,0,10
06037554403,037,554403,22,23,45
06037554404,037,554404,9,13,22
06037554521,037,554521,37,0,37
06037570003,037,570003,27,8,35
06037570100,037,570100,11,8,19
06037570304,037,570304,5,144,149
06037570601,037,570601,0,0,0
06037570602,037,570602,66,56,122
06037570701,037,570701,0,68,68
06037571400,037,571400,19,0,19
06037571800,037,571800,0,0,0
06037572100,037,572100,0,0,0
06037134201,037,134201,49,36,85
06037310701,037,310701,18,0,18
06037311000,037,311000,49,0,49
06037311100,037,311100,57,10,67
06071006401,071,006401,5,18,23
06071008001,071,008001,21,0,21
06071008404,071,008404,10,0,10
06071008901,071,008901,16,0,16
06071009300,071,009300,0,0,0
06071010021,071,010021,99,26,125
06071011700,071,011700,3,0,3
06071007104,071,007104,0,0,0
06071007105,071,007105,38,59,97
06071000808,071,000808,70,41,111
06071001400,071,001400,20,0,20
06071002204,071,002204,11,0,11
06071000304,071,000304,19,8,27
06071008500,071,008500,74,0,74
06071008002,071,008002,16,84,100
06071008403,071,008403,48,0,48
06037703100,037,703100,0,0,0
06037910403,037,910403,15,10,25
06037910807,037,910807,67,0,67
06037910810,037,910810,6,0,6
06071002401,071,002401,59,23,82
06071002402,071,002402,19,0,19
06071003700,071,003700,38,0,38
06071004601,071,004601,80,109,189
06071004700,071,004700,8,9,17
06071004800,071,004800,21,16,37
06067006201,067,006201,66,1,67
06067006500,067,006500,18,33,51
06067007014,067,007014,31,32,63
06067007206,067,007206,53,0,53
06067007504,067,007504,3,0,3
06067008005,067,008005,68,9,77
06067008135,067,008135,0,0,0
06067008139,067,008139,9,8,17
06067008143,067,008143,26,23,49
06067008144,067,008144,21,0,21
06067008907,067,008907,12,8,20
06067008912,067,008912,19,0,19
06067007011,067,007011,12,77,89
06067007209,067,007209,15,0,15
06067007403,067,007403,13,5,18
06067007421,067,007421,84,34,118
06067007422,067,007422,4,0,4
06067007501,067,007501,48,8,56
06067007701,067,007701,31,13,44
06067007801,067,007801,13,12,25
06037302504,037,302504,6,22,28
06037310201,037,310201,20,0,20
06037310202,037,310202,48,0,48
06065045119,065,045119,0,27,27
06059099407,059,099407,4,0,4
06059099602,059,099602,9,0,9
06059099701,059,099701,0,0,0
06059099803,059,099803,7,0,7
06059099906,059,099906,79,0,79
06059110004,059,110004,44,10,54
06059110008,059,110008,0,0,0
06059110011,059,110011,0,0,0
06059110117,059,110117,13,12,25
06059110118,059,110118,0,0,0
06059110202,059,110202,36,0,36
06059110301,059,110301,21,0,21
06059110303,059,110303,0,13,13
06059110401,059,110401,22,9,31
06059110015,059,110015,40,0,40
06059099512,059,099512,0,0,0
06059099905,059,099905,18,0,18
06073008345,073,008345,21,0,21
06073008355,073,008355,11,0,11
06073008356,073,008356,55,16,71
06073008359,073,008359,78,0,78
06073008360,073,008360,33,0,33
06073008504,073,008504,26,0,26
06073008702,073,008702,37,7,44
06073008902,073,008902,45,0,45
06073009101,073,009101,20,0,20
06037901010,037,901010,43,26,69
06037901011,037,901011,7,5,12
06037901209,037,901209,5,0,5
06037901210,037,901210,0,0,0
06037901213,037,901213,26,0,26
06037910001,037,910001,40,0,40
06037910002,037,910002,20,44,64
06037910101,037,910101,10,0,10
06037910207,037,910207,15,0,15
06037910208,037,910208,31,0,31
06037910209,037,910209,27,20,47
06037603801,037,603801,26,30,56
06037603802,037,603802,29,0,29
06037604001,037,604001,6,39,45
06037604002,037,604002,26,13,39
06037620305,037,620305,78,0,78
06037650401,037,650401,50,0,50
06037651304,037,651304,24,0,24
06037651401,037,651401,5,11,16
06037650604,037,650604,13,18,31
06037650605,037,650605,20,0,20
06085500902,085,500902,16,4,20
06085502001,085,502001,35,17,52
06085502102,085,502102,32,0,32
06085502202,085,502202,23,11,34
06085502400,085,502400,71,0,71
06085502500,085,502500,111,0,111
06085503305,085,503305,11,10,21
06085503306,085,503306,49,14,63
06085503504,085,503504,15,47,62
06085504315,085,504315,0,0,0
06085504319,085,504319,66,0,66
06071004202,071,004202,22,12,34
06071004401,071,004401,40,30,70
06071006302,071,006302,32,43,75
06071007404,071,007404,30,6,36
06071007901,071,007901,26,0,26
06071008301,071,008301,37,0,37
06071008302,071,008302,0,0,0
06071000105,071,000105,9,7,16
06071000107,071,000107,7,0,7
06071000201,071,000201,10,10,20
06071002601,071,002601,9,0,9
06071003000,071,003000,0,0,0
06071008704,071,008704,11,56,67
06065045121,065,045121,0,71,71
06065045122,065,045122,0,0,0
06065045123,065,045123,0,0,0
06065045124,065,045124,0,0,0
06065045125,065,045125,0,0,0
06065045212,065,045212,0,0,0
06065045213,065,045213,9,0,9
06065045214,065,045214,38,0,38
06065045215,065,045215,53,0,53
06065045216,065,045216,16,0,16
06065045217,065,045217,16,53,69
06065045222,065,045222,24,0,24
06065045224,065,045224,17,81,98
06065045226,065,045226,28,43,71
06065045228,065,045228,54,0,54
06065045233,065,045233,0,0,0
06065045304,065,045304,40,16,56
06065045303,065,045303,19,42,61
06065045606,065,045606,0,12,12
06065045608,065,045608,0,0,0
06065045609,065,045609,53,0,53
06065045707,065,045707,47,0,47
06065046500,065,046500,14,10,24
06065046601,065,046601,4,0,4
06065046602,065,046602,9,0,9
06065046700,065,046700,15,28,43
06037183402,037,183402,20,9,29
06037183701,037,183701,26,0,26
06037183702,037,183702,0,0,0
06037185203,037,185203,27,0,27
06037185204,037,185204,0,0,0
06037186201,037,186201,41,49,90
06037186202,037,186202,6,35,41
06037186203,037,186203,13,0,13
06037186301,037,186301,22,28,50
06037186302,037,186302,32,8,40
06037186403,037,186403,6,19,25
06037186404,037,186404,10,19,29
06037187101,037,187101,14,0,14
06037187102,037,187102,49,0,49
06037188201,037,188201,14,0,14
06037188202,037,188202,15,0,15
06037189101,037,189101,36,24,60
06037123205,037,123205,0,7,7
06037238310,037,238310,0,44,44
06037240010,037,240010,0,8,8
06037240600,037,240600,9,21,30
06037240700,037,240700,25,62,87
06037242100,037,242100,9,0,9
06037603703,037,603703,0,0,0
06037620501,037,620501,65,0,65
06037620601,037,620601,15,0,15
06037620800,037,620800,102,0,102
06037621001,037,621001,54,0,54
06037621201,037,621201,60,38,98
06037651101,037,651101,19,0,19
06037670003,037,670003,73,5,78
06037670201,037,670201,18,0,18
06037670407,037,670407,59,0,59
06037670702,037,670702,13,0,13
06037700600,037,700600,7,0,7
06037700902,037,700902,0,0,0
06037701601,037,701601,36,0,36
06037502500,037,502500,22,5,27
06037502601,037,502601,0,0,0
06037502602,037,502602,16,0,16
06037502902,037,502902,16,6,22
06037503402,037,503402,0,7,7
06037503701,037,503701,23,0,23
06037503802,037,503802,32,0,32
06037530101,037,530101,14,40,54
06037530500,037,530500,4,0,4
06037310300,037,310300,7,0,7
06037400206,037,400206,11,0,11
06001432502,001,432502,15,30,45
06001433103,001,433103,51,15,66
06001433104,001,433104,37,0,37
06001435103,001,435103,38,0,38
06001435104,001,435104,54,47,101
06001435601,001,435601,63,7,70
06001435602,001,435602,39,22,61
06001437101,001,437101,37,0,37
06001437102,001,437102,26,10,36
06001437701,001,437701,12,8,20
06001437702,001,437702,48,24,72
06001438203,001,438203,12,27,39
06065043244,065,043244,55,21,76
06065043246,065,043246,5,29,34
06065043247,065,043247,35,20,55
06065043248,065,043248,41,0,41
06065043252,065,043252,0,85,85
06065043250,065,043250,45,0,45
06065043254,065,043254,0,0,0
06065043256,065,043256,9,20,29
06065043257,065,043257,64,0,64
06065043262,065,043262,35,19,54
06065043264,065,043264,24,0,24
06065043265,065,043265,40,15,55
06001441503,001,441503,99,0,99
06001450605,001,450605,22,0,22
06001433400,001,433400,60,0,60
06001441200,001,441200,68,0,68
06001444400,001,444400,32,0,32
06001436200,001,436200,0,0,0
06001437900,001,437900,5,0,5
06001441700,001,441700,66,0,66
06067006003,067,006003,27,14,41
06067006101,067,006101,34,0,34
06067006102,067,006102,38,22,60
06059052428,059,052428,29,0,29
06059052514,059,052514,21,0,21
06059099306,059,099306,58,0,58
06059099402,059,099402,0,50,50
06037550400,037,550400,0,0,0
06037554101,037,554101,0,8,8
06037554512,037,554512,36,0,36
06037554513,037,554513,12,6,18
06037554801,037,554801,13,10,23
06037554802,037,554802,0,9,9
06037800504,037,800504,0,0,0
06037800506,037,800506,14,0,14
06037900103,037,900103,0,7,7
06037900104,037,900104,12,0,12
06037900201,037,900201,11,0,11
06037900505,037,900505,0,10,10
06037900506,037,900506,6,15,21
06037900507,037,900507,7,0,7
06037900508,037,900508,21,15,36
06037900608,037,900608,0,0,0
06037901008,037,901008,16,0,16
06037900609,037,900609,22,0,22
06037901009,037,901009,0,11,11
06037620904,037,620904,0,0,0
06037621004,037,621004,0,0,0
06037621104,037,621104,27,60,87
06037621204,037,621204,25,10,35
06037621324,037,621324,13,14,27
06037621326,037,621326,5,0,5
06037650003,037,650003,5,8,13
06037650004,037,650004,39,0,39
06001427300,001,427300,32,0,32
06001427600,001,427600,26,29,55
06001427900,001,427900,80,0,80
06001428302,001,428302,32,0,32
06001428600,001,428600,3,23,26
06001430800,001,430800,57,0,57
06001433600,001,433600,0,20,20
06001437400,001,437400,38,0,38
06001438201,001,438201,20,0,20
06001423000,001,423000,28,0,28
06001428100,001,428100,53,0,53
06001428400,001,428400,32,0,32
06001430200,001,430200,0,0,0
06001432200,001,432200,32,0,32
06001432400,001,432400,0,71,71
06001433800,001,433800,15,0,15
06001434000,001,434000,22,6,28
06001435102,001,435102,8,0,8
06001435500,001,435500,0,0,0
06001438000,001,438000,34,9,43
06001440307,001,440307,0,0,0
06001441401,001,441401,11,0,11
06001441601,001,441601,0,7,7
06071008706,071,008706,149,34,183
06071009709,071,009709,16,0,16
06067008113,067,008113,8,31,39
06059052526,059,052526,42,0,42
06059062612,059,062612,0,0,0
06059062620,059,062620,18,0,18
06059062643,059,062643,19,0,19
06059062701,059,062701,11,0,11
06059063005,059,063005,0,0,0
06059063603,059,063603,0,0,0
06059063805,059,063805,18,0,18
06059063807,059,063807,11,42,53
06059063902,059,063902,54,0,54
06059074003,059,074003,11,6,17
06059074110,059,074110,18,0,18
06037670202,037,670202,0,0,0
06037800101,037,800101,17,9,26
06037920111,037,920111,11,0,11
06037531000,037,531000,37,26,63
06037530004,037,530004,13,0,13
06037530301,037,530301,9,11,20
06037530901,037,530901,31,4,35
06037532001,037,532001,9,0,9
06037532500,037,532500,41,9,50
06037533403,037,533403,0,22,22
06037533501,037,533501,10,0,10
06073003004,073,003004,23,30,53
06073003109,073,003109,5,4,9
06073003112,073,003112,13,0,13
06073003213,073,003213,0,0,0
06073003601,073,003601,0,0,0
06073003901,073,003901,21,13,34
06073004501,073,004501,0,9,9
06073004600,073,004600,16,0,16
06067007019,067,007019,21,14,35
06067007020,067,007020,18,47,65
06067007101,067,007101,0,0,0
06067007102,067,007102,47,0,47
06067007103,067,007103,72,0,72
06037553000,037,553000,10,50,60
06037553400,037,553400,13,24,37
06065045114,065,045114,0,0,0
06065045115,065,045115,0,0,0
06065045116,065,045116,0,0,0
06065045117,065,045117,0,0,0
06065045120,065,045120,43,0,43
06065045118,065,045118,0,20,20
06067007104,067,007104,35,0,35
06067007105,067,007105,78,0,78
06067007106,067,007106,59,18,77
06067007107,067,007107,46,21,67
06067007426,067,007426,14,0,14
06037120103,037,120103,30,5,35
06037120104,037,120104,11,4,15
06037120105,037,120105,0,0,0
06037120106,037,120106,0,14,14
06037910713,037,910713,0,0,0
06037910714,037,910714,32,7,39
06037910715,037,910715,20,36,56
06037910716,037,910716,29,35,64
06073018000,073,018000,24,41,65
06073018200,073,018200,0,13,13
06073018507,073,018507,108,0,108
06073003003,073,003003,43,0,43
06073003105,073,003105,112,0,112
06073003201,073,003201,55,73,128
06073003209,073,003209,0,22,22
06073003301,073,003301,34,6,40
06073003401,073,003401,103,0,103
06073004200,073,004200,50,0,50
06073004300,073,004300,36,0,36
06073005600,073,005600,0,0,0
06073008101,073,008101,0,0,0
06073008313,073,008313,14,0,14
06073008331,073,008331,6,0,6
06073008343,073,008343,44,0,44
06037134905,037,134905,32,0,32
06037135113,037,135113,8,0,8
06037135114,037,135114,37,0,37
06037137103,037,137103,146,0,146
06037139001,037,139001,0,0,0
06037134904,037,134904,26,0,26
06037137104,037,137104,20,0,20
06037139401,037,139401,26,0,26
06037139402,037,139402,20,0,20
06037221110,037,221110,0,0,0
06037221120,037,221120,0,16,16
06037222500,037,222500,17,15,32
06037224020,037,224020,0,0,0
06037224320,037,224320,0,18,18
06037227020,037,227020,0,1,1
06037228720,037,228720,0,23,23
06037229200,037,229200,0,52,52
06037231300,037,231300,18,31,49
06037231710,037,231710,7,17,24
06037232700,037,232700,0,20,20
06037236202,037,236202,36,32,68
06037405600,037,405600,9,27,36
06037405900,037,405900,29,0,29
06037406000,037,406000,21,18,39
06037406411,037,406411,26,11,37
06037406412,037,406412,3,6,9
06037407400,037,407400,27,8,35
06037408302,037,408302,18,0,18
06037408503,037,408503,42,14,56
06037408624,037,408624,12,0,12
06037480012,037,480012,14,9,23
06037462500,037,462500,69,16,85
06037462600,037,462600,18,0,18
06059110201,059,110201,17,0,17
06059110302,059,110302,50,35,85
06059086502,059,086502,39,9,48
06059086602,059,086602,67,0,67
06059088401,059,088401,50,11,61
06059088501,059,088501,41,0,41
06085504414,085,504414,90,18,108
06085504415,085,504415,48,0,48
06085504504,085,504504,45,1,46
06085507703,085,507703,0,0,0
06085506502,085,506502,10,0,10
06085506605,085,506605,28,0,28
06085506606,085,506606,36,0,36
06085507807,085,507807,30,0,30
06059099217,059,099217,14,0,14
06059099220,059,099220,0,0,0
06059099224,059,099224,0,7,7
06059099234,059,099234,11,0,11
06059099235,059,099235,0,11,11
06059099243,059,099243,20,10,30
06059099311,059,099311,9,0,9
06059099410,059,099410,0,0,0
06059099510,059,099510,0,0,0
06059099702,059,099702,43,0,43
06059099802,059,099802,7,8,15
06037137301,037,137301,51,0,51
06037139302,037,139302,46,0,46
06037137401,037,137401,58,7,65
06037137402,037,137402,0,0,0
06037139200,037,139200,62,0,62
06037139703,037,139703,12,0,12
06037139801,037,139801,0,0,0
06037141600,037,141600,23,0,23
06073002602,073,002602,0,15,15
06073003107,073,003107,26,0,26
06073003204,073,003204,39,0,39
06073003208,073,003208,0,0,0
06073003800,073,003800,13,0,13
06073004400,073,004400,19,0,19
06073001200,073,001200,19,0,19
06073002501,073,002501,19,0,19
06073002502,073,002502,16,31,47
06073002904,073,002904,0,0,0
06073003103,073,003103,13,14,27
06073003113,073,003113,84,0,84
06073001400,073,001400,29,0,29
06073002001,073,002001,9,10,19
06073002202,073,002202,4,24,28
06073002402,073,002402,9,24,33
06073002601,073,002601,19,35,54
06073002804,073,002804,14,17,31
06073002905,073,002905,40,22,62
06073017104,073,017104,0,0,0
06073017200,073,017200,0,0,0
06073017809,073,017809,37,0,37
06073017900,073,017900,150,0,150
06073018510,073,018510,35,21,56
06073018512,073,018512,7,0,7
06073018513,073,018513,68,21,89
06073018603,073,018603,25,36,61
06073012401,073,012401,0,0,0
06073018515,073,018515,18,0,18
06073018518,073,018518,0,21,21
06073019001,073,019001,0,0,0
06037143400,037,143400,32,45,77
06037181000,037,181000,13,0,13
06037183520,037,183520,0,15,15
06037191204,037,191204,18,11,29
06037191620,037,191620,0,12,12
06037191820,037,191820,24,0,24
06037192510,037,192510,30,0,30
06037192520,037,192520,0,0,0
06037192610,037,192610,0,10,10
06037194500,037,194500,6,0,6
06037195300,037,195300,0,0,0
06037195600,037,195600,0,9,9
06037199400,037,199400,0,15,15
06071000826,071,000826,63,0,63
06071000901,071,000901,14,28,42
06071000903,071,000903,12,17,29
06071000904,071,000904,11,0,11
06071001001,071,001001,30,5,35
06073019103,073,019103,22,0,22
06073019206,073,019206,17,16,33
06073019303,073,019303,11,15,26
06073019405,073,019405,27,20,47
06073019406,073,019406,10,46,56
06073000400,073,000400,36,0,36
06073000500,073,000500,52,0,52
06073000900,073,000900,0,0,0
06073002302,073,002302,30,0,30
06073002710,073,002710,17,0,17
06067008129,067,008129,7,8,15
06067008204,067,008204,28,0,28
06067002800,067,002800,0,0,0
06067004801,067,004801,0,37,37
06067007424,067,007424,0,11,11
06067008124,067,008124,11,0,11
06065041810,065,041810,22,0,22
06065041904,065,041904,51,34,85
06065042010,065,042010,19,22,41
06065042207,065,042207,10,0,10
06065042209,065,042209,0,70,70
06065042210,065,042210,21,11,32
06065042300,065,042300,32,12,44
06065044804,065,044804,18,0,18
06065044805,065,044805,16,0,16
06065045604,065,045604,55,20,75
06065045900,065,045900,15,0,15
06065046102,065,046102,9,28,37
06065046401,065,046401,0,0,0
06065046402,065,046402,0,4,4
06065041412,065,041412,64,0,64
06065041807,065,041807,17,0,17
06065041813,065,041813,16,7,23
06065049000,065,049000,44,81,125
06065049100,065,049100,0,0,0
06065049400,065,049400,10,0,10
06065048901,065,048901,36,6,42
06065048902,065,048902,23,11,34
06065049500,065,049500,6,23,29
06059062644,059,062644,15,0,15
06065049600,065,049600,20,0,20
06065049700,065,049700,66,0,66
06065049800,065,049800,28,0,28
06065050300,065,050300,63,34,97
06065050400,065,050400,14,18,32
06065050500,065,050500,139,79,218
06065050600,065,050600,72,0,72
06065050700,065,050700,71,10,81
06065050900,065,050900,25,0,25
06065051100,065,051100,44,0,44
06065051200,065,051200,0,0,0
06065051300,065,051300,0,98,98
06065051400,065,051400,0,0,0
06065940400,065,940400,34,13,47
06067004502,067,004502,13,95,108
06085503333,085,503333,33,0,33
06085503334,085,503334,51,20,71
06085503336,085,503336,21,20,41
06085503337,085,503337,0,6,6
06085503710,085,503710,28,0,28
06085503711,085,503711,30,16,46
06085503712,085,503712,8,17,25
06085503713,085,503713,4,0,4
06085503902,085,503902,111,0,111
06085503903,085,503903,12,0,12
06085504322,085,504322,41,0,41
06065040813,065,040813,0,0,0
06065040814,065,040814,24,13,37
06065040815,065,040815,9,18,27
06065040816,065,040816,11,0,11
06065040821,065,040821,26,0,26
06065041101,065,041101,60,0,60
06065041102,065,041102,19,0,19
06065041301,065,041301,46,6,52
06065041302,065,041302,16,22,38
06065041910,065,041910,57,0,57
06065041911,065,041911,88,0,88
06037212701,037,212701,0,0,0
06037212502,037,212502,0,9,9
06037212702,037,212702,0,0,0
06037214501,037,214501,29,0,29
06037214502,037,214502,0,0,0
06037214503,037,214503,53,2,55
06037214901,037,214901,16,0,16
06037214902,037,214902,69,0,69
06085504323,085,504323,72,0,72
06085505009,085,505009,89,8,97
06085508003,085,508003,20,0,20
06085508004,085,508004,22,0,22
06085508507,085,508507,76,0,76
06085508508,085,508508,28,6,34
06085504423,085,504423,9,0,9
06085505008,085,505008,129,0,129
06085511301,085,511301,20,0,20
06037910811,037,910811,0,0,0
06037910812,037,910812,0,0,0
06037910813,037,910813,0,12,12
06037911001,037,911001,0,0,0
06037920011,037,920011,0,0,0
06037920012,037,920012,5,0,5
06037532002,037,532002,0,23,23
06037532101,037,532101,18,10,28
06037532604,037,532604,8,18,26
06037533804,037,533804,0,0,0
06037533901,037,533901,38,0,38
06037534001,037,534001,48,17,65
06037534403,037,534403,0,22,22
06037534406,037,534406,20,20,40
06037534502,037,534502,0,50,50
06037535101,037,535101,36,20,56
06037535503,037,535503,6,24,30
06037535604,037,535604,32,20,52
06037271300,037,271300,10,46,56
06037215101,037,215101,31,0,31
06037215102,037,215102,13,0,13
06037216401,037,216401,13,0,13
06037216402,037,216402,29,0,29
06037217001,037,217001,38,0,38
06037217002,037,217002,0,15,15
06037218701,037,218701,9,15,24
06037218702,037,218702,0,14,14
06037219901,037,219901,14,0,14
06037219902,037,219902,13,19,32
06037221303,037,221303,0,13,13
06037221304,037,221304,13,0,13
06071000115,071,000115,119,0,119
06071000116,071,000116,59,0,59
06071000113,071,000113,38,72,110
06071000117,071,000117,17,0,17
06071010004,071,010004,50,0,50
06071010014,071,010014,5,0,5
06071010016,071,010016,11,0,11
06071010017,071,010017,0,0,0
06071010023,071,010023,18,26,44
06071010300,071,010300,7,6,13
06071011300,071,011300,0,0,0
06071000103,071,000103,39,0,39
06071001200,071,001200,18,8,26
06071001600,071,001600,13,0,13
06037533601,037,533601,0,0,0
06037534803,037,534803,4,23,27
06037535603,037,535603,10,0,10
06037535902,037,535902,24,0,24
06037540102,037,540102,11,80,91
06037540502,037,540502,53,65,118
06037540800,037,540800,34,0,34
06037541300,037,541300,7,7,14
06037541400,037,541400,69,34,103
06037542900,037,542900,12,28,40
06037550700,037,550700,15,0,15
06037551800,037,551800,22,63,85
06037211410,037,211410,0,0,0
06037211500,037,211500,0,6,6
06037212420,037,212420,17,13,30
06037212800,037,212800,8,0,8
06037213100,037,213100,21,0,21
06037216300,037,216300,61,0,61
06037219800,037,219800,9,9,18
06037222700,037,222700,0,0,0
06037224310,037,224310,15,15,30
06037224420,037,224420,0,17,17
06037228220,037,228220,6,18,24
06037228320,037,228320,9,4,13
06037228410,037,228410,15,28,43
06037228420,037,228420,3,0,3
06067004006,067,004006,45,0,45
06067004010,067,004010,11,0,11
06067004011,067,004011,19,0,19
06067004903,067,004903,39,23,62
06067004906,067,004906,10,0,10
06067005002,067,005002,13,77,90
06067005506,067,005506,0,0,0
06067005801,067,005801,67,0,67
06067006300,067,006300,44,13,57
06067007012,067,007012,25,0,25
06067007204,067,007204,27,0,27
06067007423,067,007423,0,49,49
06067007905,067,007905,46,14,60
06067007906,067,007906,29,0,29
06067008128,067,008128,6,0,6
06067008141,067,008141,34,38,72
06067008142,067,008142,0,35,35
06067008403,067,008403,0,0,0
06037228500,037,228500,9,24,33
06037228900,037,228900,10,8,18
06037229420,037,229420,13,6,19
06037231220,037,231220,20,0,20
06037231500,037,231500,0,87,87
06037234200,037,234200,26,0,26
06067003300,067,003300,37,0,37
06067003400,067,003400,44,0,44
06067004005,067,004005,38,0,38
06067004402,067,004402,35,4,39
06067005102,067,005102,41,25,66
06067005402,067,005402,0,0,0
06067005403,067,005403,0,0,0
06067005702,067,005702,18,6,24
06067005803,067,005803,0,0,0
06067002000,067,002000,0,9,9
06037570303,037,570303,9,12,21
06037570603,037,570603,0,67,67
06037570702,037,570702,15,0,15
06037576200,037,576200,0,0,0
06037577100,037,577100,125,0,125
06037577200,037,577200,14,0,14
06071002021,071,002021,35,0,35
06071002022,071,002022,30,10,40
06071002023,071,002023,18,13,31
06071002025,071,002025,52,0,52
06071002027,071,002027,39,0,39
06071002028,071,002028,0,7,7
06071002029,071,002029,0,11,11
06071002031,071,002031,53,0,53
06071002033,071,002033,74,64,138
06071002034,071,002034,39,0,39
06071002035,071,002035,62,0,62
06071002036,071,002036,194,44,238
06071002101,071,002101,7,0,7
06071002037,071,002037,45,0,45
06001442700,001,442700,15,0,15
06001451201,001,451201,73,42,115
06001451401,001,451401,59,16,75
06001451602,001,451602,84,0,84
06001400300,001,400300,50,0,50
06001401800,001,401800,10,0,10
06001404502,001,404502,87,0,87
06001406700,001,406700,0,21,21
06001408600,001,408600,27,55,82
06001409000,001,409000,54,18,72
06001409800,001,409800,0,36,36
06001410000,001,410000,22,12,34
06001421200,001,421200,14,0,14
06001423500,001,423500,40,10,50
06037600501,037,600501,5,3,8
06037600502,037,600502,0,17,17
06037600702,037,600702,30,0,30
06073004700,073,004700,9,0,9
06037910504,037,910504,6,35,41
06037910505,037,910505,11,0,11
06037910210,037,910210,75,0,75
06037910605,037,910605,17,0,17
06037910606,037,910606,26,0,26
06037910711,037,910711,37,0,37
06037910712,037,910712,0,8,8
06073019803,073,019803,66,13,79
06073019903,073,019903,30,14,44
06001424002,001,424002,8,4,12
06001430900,001,430900,35,45,80
06001431000,001,431000,40,23,63
06001432800,001,432800,16,9,25
06001433102,001,433102,23,44,67
06085507904,085,507904,5,0,5
06085508504,085,508504,100,0,100
06085508505,085,508505,37,0,37
06085508704,085,508704,32,0,32
06037577603,037,577603,25,0,25
06037601002,037,601002,53,16,69
06037601401,037,601401,36,31,67
06037602004,037,602004,0,0,0
06037602301,037,602301,48,55,103
06037602403,037,602403,11,36,47
06037603001,037,603001,1,0,1
06037503401,037,503401,97,0,97
06037532400,037,532400,0,0,0
06037402502,037,402502,54,17,71
06037404600,037,404600,0,7,7
06037301204,037,301204,36,0,36
06037311600,037,311600,96,0,96
06073013308,073,013308,7,0,7
06073013309,073,013309,12,0,12
06073013410,073,013410,78,32,110
06073013418,073,013418,52,85,137
06073013504,073,013504,31,0,31
06073013601,073,013601,69,60,129
06073013903,073,013903,33,11,44
06073013907,073,013907,0,0,0
06073014602,073,014602,110,0,110
06073014803,073,014803,11,48,59
06073015701,073,015701,31,104,135
06073016617,073,016617,15,0,15
06073016810,073,016810,33,0,33
06073016811,073,016811,16,0,16
06073017014,073,017014,0,0,0
06073017019,073,017019,0,0,0
06073017032,073,017032,0,0,0
06073017037,073,017037,46,15,61
06073017106,073,017106,14,16,30
06073017601,073,017601,26,0,26
06073000100,073,000100,0,0,0
06067007402,067,007402,35,23,58
06067007406,067,007406,60,17,77
06067007802,067,007802,9,0,9
06067008911,067,008911,11,49,60
06067009105,067,009105,13,29,42
06067009504,067,009504,6,9,15
06067009616,067,009616,8,38,46
06067007001,067,007001,9,0,9
06067007602,067,007602,13,17,30
06067009108,067,009108,0,43,43
06067008207,067,008207,40,0,40
06067008909,067,008909,5,13,18
06067009609,067,009609,17,9,26
06067009323,067,009323,46,48,94
06067008131,067,008131,31,43,74
06067009109,067,009109,10,0,10
06067009800,067,009800,13,0,13
06067005001,067,005001,30,47,77
06067007013,067,007013,0,17,17
06067008510,067,008510,49,0,49
06067008512,067,008512,56,0,56
06067008513,067,008513,13,0,13
06067008703,067,008703,31,0,31
06067008704,067,008704,46,0,46
06067008705,067,008705,119,0,119
06067008801,067,008801,28,0,28
06067009010,067,009010,33,0,33
06067009011,067,009011,23,0,23
06067009201,067,009201,10,6,16
06067009324,067,009324,12,5,17
06067009325,067,009325,0,0,0
06067009326,067,009326,36,0,36
06067009328,067,009328,36,12,48
06067009329,067,009329,5,0,5
06067009330,067,009330,11,27,38
06073000600,073,000600,17,0,17
06073012003,073,012003,6,4,10
06073013203,073,013203,47,18,65
06073013204,073,013204,11,6,17
06073013301,073,013301,19,0,19
06073013303,073,013303,48,0,48
06067009331,067,009331,52,0,52
06067009332,067,009332,7,6,13
06067009407,067,009407,25,67,92
06067009408,067,009408,23,0,23
06067009622,067,009622,87,21,108
06067009630,067,009630,74,0,74
06067009632,067,009632,52,0,52
06067009633,067,009633,40,0,40
06067009634,067,009634,0,8,8
06067009635,067,009635,44,31,75
06067009636,067,009636,103,0,103
06067009637,067,009637,74,0,74
06067009638,067,009638,29,0,29
06067009639,067,009639,27,29,56
06067009900,067,009900,0,0,0
06037189102,037,189102,13,0,13
06037189201,037,189201,0,0,0
06037189202,037,189202,15,0,15
06037189903,037,189903,0,0,0
06037189904,037,189904,0,0,0
06037189905,037,189905,9,0,9
06037190201,037,190201,0,0,0
06037190202,037,190202,0,17,17
06037190401,037,190401,0,0,0
06037190402,037,190402,0,0,0
06037190801,037,190801,4,0,4
06037702803,037,702803,9,18,27
06037900806,037,900806,20,0,20
06037271500,037,271500,30,0,30
06037277200,037,277200,4,21,25
06037201401,037,201401,4,29,33
06037400304,037,400304,0,0,0
06037294110,037,294110,38,12,50
06037296300,037,296300,3,19,22
06037297000,037,297000,16,0,16
06037301203,037,301203,21,0,21
06037310703,037,310703,15,0,15
06037400602,037,400602,0,24,24
06037575901,037,575901,0,40,40
06037199800,037,199800,12,33,45
06037201504,037,201504,0,5,5
06037204820,037,204820,0,10,10
06037206200,037,206200,8,0,8
06037208720,037,208720,0,0,0
06037211802,037,211802,0,0,0
06037212204,037,212204,15,13,28
06037212303,037,212303,4,0,4
06037212306,037,212306,0,0,0
06037213310,037,213310,0,0,0
06037214000,037,214000,19,0,19
06071005100,071,005100,47,40,87
06071006402,071,006402,0,50,50
06071008402,071,008402,0,0,0
06071009400,071,009400,30,31,61
06071009707,071,009707,0,0,0
06071009708,071,009708,0,9,9
06071009711,071,009711,44,0,44
06071009714,071,009714,9,6,15
06071003200,071,003200,0,54,54
06037920037,037,920037,0,117,117
06037920042,037,920042,52,100,152
06037920107,037,920107,45,0,45
06037920328,037,920328,0,0,0
06037900804,037,900804,14,60,74
06037551201,037,551201,0,0,0
06037551600,037,551600,0,0,0
06037900704,037,900704,18,42,60
06037900805,037,900805,0,32,32
06037900900,037,900900,10,0,10
06037910206,037,910206,18,7,25
06037910301,037,910301,12,0,12
06037910502,037,910502,0,0,0
06037910707,037,910707,0,0,0
06037920017,037,920017,26,0,26
06037543701,037,543701,35,0,35
06037543702,037,543702,53,0,53
06037543801,037,543801,57,11,68
06037551300,037,551300,16,24,40
06037120107,037,120107,9,0,9
06037120108,037,120108,19,12,31
06037121101,037,121101,46,0,46
06037121102,037,121102,8,8,16
06059063008,059,063008,0,0,0
06037310501,037,310501,7,35,42
06037302505,037,302505,12,0,12
06037302506,037,302506,0,0,0
06037310601,037,310601,24,0,24
06037310602,037,310602,28,0,28
06037320201,037,320201,0,10,10
06037132501,037,132501,48,6,54
06037132502,037,132502,0,12,12
06037134001,037,134001,19,25,44
06037134521,037,134521,13,9,22
06037134903,037,134903,18,46,64
06037134002,037,134002,23,0,23
06037134423,037,134423,0,0,0
06037134424,037,134424,3,0,3
06037134522,037,134522,0,29,29
06059052423,059,052423,34,0,34
06059052519,059,052519,65,0,65
06065030502,065,030502,0,14,14
06065031703,065,031703,10,0,10
06037242000,037,242000,0,52,52
06037242700,037,242700,9,69,78
06037267200,037,267200,13,0,13
06037267600,037,267600,12,0,12
06037402301,037,402301,18,9,27
06037402403,037,402403,25,21,46
06037134302,037,134302,13,0,13
06037134303,037,134303,34,0,34
06037134421,037,134421,11,13,24
06037134520,037,134520,0,32,32
06037135111,037,135111,64,0,64
06059074407,059,074407,24,19,43
06059074802,059,074802,33,60,93
06059075100,059,075100,37,28,65
06065046800,065,046800,26,0,26
06065046900,065,046900,11,0,11
06065047000,065,047000,0,9,9
06065047201,065,047201,0,0,0
06065047202,065,047202,0,0,0
06065047900,065,047900,94,13,107
06065048100,065,048100,41,28,69
06065048200,065,048200,39,10,49
06065048300,065,048300,19,0,19
06065048700,065,048700,75,0,75
06065048800,065,048800,27,21,48
06037463900,037,463900,0,0,0
06037464200,037,464200,81,0,81
06037297120,037,297120,40,0,40
06037297400,037,297400,0,0,0
06037300501,037,300501,34,0,34
06037300502,037,300502,0,0,0
06037301000,037,301000,64,0,64
06037301602,037,301602,12,0,12
06037302301,037,302301,11,0,11
06037311200,037,311200,20,0,20
06037400800,037,400800,19,0,19
06037401704,037,401704,0,33,33
06037401800,037,401800,0,0,0
06037541801,037,541801,13,0,13
06037542200,037,542200,16,55,71
06037542402,037,542402,0,0,0
06037542700,037,542700,8,45,53
06037543305,037,543305,0,16,16
06037543501,037,543501,29,15,44
06037543903,037,543903,0,26,26
06037550000,037,550000,0,11,11
06037401902,037,401902,14,0,14
06037403500,037,403500,3,0,3
06037555002,037,555002,20,0,20
06037572301,037,572301,21,37,58
06037575102,037,575102,19,5,24
06037600911,037,600911,0,17,17
06037603600,037,603600,29,0,29
06037621002,037,621002,6,19,25
06037700400,037,700400,45,17,62
06037702501,037,702501,93,0,93
06037900705,037,900705,26,16,42
06037463102,037,463102,27,0,27
06037482402,037,482402,18,0,18
06037533401,037,533401,0,7,7
06037534301,037,534301,48,0,48
06037542000,037,542000,3,0,3
06001433700,001,433700,76,10,86
06001407300,001,407300,0,12,12
06001421500,001,421500,6,0,6
06073009704,073,009704,74,0,74
06073008800,073,008800,27,22,49
06073009106,073,009106,19,0,19
06073008311,073,008311,0,0,0
06073013606,073,013606,0,15,15
06073013802,073,013802,5,0,5
06073013905,073,013905,34,0,34
06073014200,073,014200,20,0,20
06073014300,073,014300,46,0,46
06073015200,073,015200,0,0,0
06065043266,065,043266,29,26,55
06065043267,065,043267,38,23,61
06065043270,065,043270,0,0,0
06065043271,065,043271,34,0,34
06065043272,065,043272,11,0,11
06065043276,065,043276,15,0,15
06065043278,065,043278,0,11,11
06065043279,065,043279,43,10,53
06065043291,065,043291,30,35,65
06065043316,065,043316,6,0,6
06065043317,065,043317,0,0,0
06065043512,065,043512,56,12,68
06065043513,065,043513,7,0,7
06065043517,065,043517,50,0,50
06065043274,065,043274,4,0,4
06065043810,065,043810,0,21,21
06065043811,065,043811,0,45,45
06065043812,065,043812,0,0,0
06065043814,065,043814,0,0,0
06065043601,065,043601,5,39,44
06065043602,065,043602,61,0,61
06065043813,065,043813,0,38,38
06065043818,065,043818,10,0,10
06065043820,065,043820,54,0,54
06065031401,065,031401,19,63,82
06065040807,065,040807,48,0,48
06065041001,065,041001,0,0,0
06037277000,037,277000,59,0,59
06037291130,037,291130,9,9,18
06073013307,073,013307,56,52,108
06073013401,073,013401,42,12,54
06073013415,073,013415,0,0,0
06073005700,073,005700,7,0,7
06073005800,073,005800,24,0,24
06073006801,073,006801,0,10,10
06073018611,073,018611,51,12,63
06073019203,073,019203,7,0,7
06073019501,073,019501,6,13,19
06073019804,073,019804,4,0,4
06073019805,073,019805,59,0,59
06073020018,073,020018,31,0,31
06073020108,073,020108,12,88,100
06073020401,073,020401,6,6,12
06073020404,073,020404,7,0,7
06073020709,073,020709,44,0,44
06073007800,073,007800,28,0,28
06073008002,073,008002,68,0,68
06073008349,073,008349,43,10,53
06073008353,073,008353,18,0,18
06073008357,073,008357,48,0,48
06073008503,073,008503,25,0,25
06073008506,073,008506,22,0,22
06073008901,073,008901,27,19,46
06073009107,073,009107,0,27,27
06073009901,073,009901,5,4,9
06073010109,073,010109,6,31,37
06073011100,073,011100,29,0,29
06073012101,073,012101,7,3,10
06073020025,073,020025,17,0,17
06073020017,073,020017,0,12,12
06073020022,073,020022,131,0,131
06073020023,073,020023,34,0,34
06073020105,073,020105,54,34,88
06073020210,073,020210,19,0,19
06073020710,073,020710,4,0,4
06073020109,073,020109,0,19,19
06037212202,037,212202,37,0,37
06037432500,037,432500,0,22,22
06037433802,037,433802,7,8,15
06037462900,037,462900,65,9,74
06037404302,037,404302,17,16,33
06037433402,037,433402,0,16,16
06037461000,037,461000,0,0,0
06037480702,037,480702,7,15,22
06037530302,037,530302,23,13,36
06037532102,037,532102,0,40,40
06037201503,037,201503,22,38,60
06037207400,037,207400,5,0,5
06037208903,037,208903,30,27,57
06037209200,037,209200,0,8,8
06037210010,037,210010,0,0,0
06037211420,037,211420,21,0,21
06037212203,037,212203,11,18,29
06037212610,037,212610,34,0,34
06037214400,037,214400,17,0,17
06037214600,037,214600,0,0,0
06037218120,037,218120,33,0,33
06037218500,037,218500,16,6,22
06037221210,037,221210,8,0,8
06037221302,037,221302,0,0,0
06037224200,037,224200,19,18,37
06037463500,037,463500,41,0,41
06037460900,037,460900,39,44,83
06037461100,037,461100,10,27,37
06037461700,037,461700,11,7,18
06037480101,037,480101,0,0,0
06037480802,037,480802,0,0,0
06037501504,037,501504,39,11,50
06037501600,037,501600,20,5,25
06037530203,037,530203,0,56,56
06037530400,037,530400,12,14,26
06037531201,037,531201,0,17,17
06037531202,037,531202,0,0,0
06037531800,037,531800,0,36,36
06059021807,059,021807,21,28,49
06059021825,059,021825,30,0,30
06059032034,059,032034,55,0,55
06059086903,059,086903,15,37,52
06059088002,059,088002,28,27,55
06059088202,059,088202,13,10,23
06001406000,001,406000,0,0,0
06001406100,001,406100,0,0,0
06001406500,001,406500,48,0,48
06001407500,001,407500,12,23,35
06001407900,001,407900,49,0,49
06001408100,001,408100,48,19,67
06001408500,001,408500,109,38,147
06001408700,001,408700,19,64,83
06001409200,001,409200,6,7,13
06001409500,001,409500,12,0,12
06001409600,001,409600,4,16,20
06001410200,001,410200,0,64,64
06001421300,001,421300,14,11,25
06001421700,001,421700,46,0,46
06001422000,001,422000,37,16,53
06001422300,001,422300,65,0,65
06001422800,001,422800,0,0,0
06001423602,001,423602,0,0,0
06001427100,001,427100,25,0,25
06001430500,001,430500,47,0,47
06001430600,001,430600,32,15,47
06001430700,001,430700,19,8,27
06001400200,001,400200,13,0,13
06001401100,001,401100,29,0,29
06001401400,001,401400,13,0,13
06059052515,059,052515,20,0,20
06059052517,059,052517,198,0,198
06059052518,059,052518,0,15,15
06037501503,037,501503,0,0,0
06037530003,037,530003,12,0,12
06037530902,037,530902,0,12,12
06037531604,037,531604,17,0,17
06037533105,037,533105,0,0,0
06037533106,037,533106,0,3,3
06037310100,037,310100,56,0,56
06037310400,037,310400,16,0,16
06037320300,037,320300,13,37,50
06001400700,001,400700,19,0,19
06001402700,001,402700,0,14,14
06001402900,001,402900,0,0,0
06001403400,001,403400,61,0,61
06001404600,001,404600,53,0,53
06001406201,001,406201,41,24,65
06001406800,001,406800,55,1,56
06001407800,001,407800,8,0,8
06001408000,001,408000,23,0,23
06001408200,001,408200,12,20,32
06001409900,001,409900,48,0,48
06001420200,001,420200,31,0,31
06037401603,037,401603,17,0,17
06037401701,037,401701,8,0,8
06037121221,037,121221,14,0,14
06037121222,037,121222,0,38,38
06037121801,037,121801,0,0,0
06037121802,037,121802,10,7,17
06037122121,037,122121,0,0,0
06037122122,037,122122,0,26,26
06037123901,037,123901,0,16,16
06037123902,037,123902,21,0,21
06037124103,037,124103,0,0,0
06037124104,037,124104,21,0,21
06037124105,037,124105,0,0,0
06059042333,059,042333,0,0,0
06059052404,059,052404,0,0,0
06059052415,059,052415,0,0,0
06059052418,059,052418,114,0,114
06059052419,059,052419,36,15,51
06059052421,059,052421,22,17,39
06073013310,073,013310,136,0,136
06073013314,073,013314,107,67,174
06073013420,073,013420,31,7,38
06073013421,073,013421,11,0,11
06001420500,001,420500,29,6,35
06001421600,001,421600,50,0,50
06001421900,001,421900,32,0,32
06001422200,001,422200,27,0,27
06001435700,001,435700,37,0,37
06001436100,001,436100,26,0,26
06001438204,001,438204,8,0,8
06001440333,001,440333,33,0,33
06001440334,001,440334,65,11,76
06001440335,001,440335,164,0,164
06001440336,001,440336,28,30,58
06001441523,001,441523,68,0,68
06001441524,001,441524,50,0,50
06001441924,001,441924,51,0,51
06001441925,001,441925,123,34,157
06001441926,001,441926,30,4,34
06001441927,001,441927,83,0,83
06001442301,001,442301,54,0,54
06001442601,001,442601,0,33,33
06001442602,001,442602,9,10,19
06001443104,001,443104,12,0,12
06001443105,001,443105,37,0,37
06001442302,001,442302,8,0,8
06037262501,037,262501,11,0,11
06037262604,037,262604,0,0,0
06037262704,037,262704,0,0,0
06037262706,037,262706,11,0,11
06037262802,037,262802,10,0,10
06059074702,059,074702,13,22,35
06059075405,059,075405,0,0,0
06059075604,059,075604,37,0,37
06059075607,059,075607,18,0,18
06073014901,073,014901,9,0,9
06073016503,073,016503,22,25,47
06073016504,073,016504,93,41,134
06073003501,073,003501,0,16,16
06073005200,073,005200,17,0,17
06073006000,073,006000,41,0,41
06073005000,073,005000,5,33,38
06073006200,073,006200,0,0,0
06073007600,073,007600,16,0,16
06073017047,073,017047,21,0,21
06073017107,073,017107,7,0,7
06073018504,073,018504,40,0,40
06073018509,073,018509,10,0,10
06073018517,073,018517,0,0,0
06073018612,073,018612,0,9,9
06037553801,037,553801,0,0,0
06037554511,037,554511,0,0,0
06037554515,037,554515,7,0,7
06037554517,037,554517,0,0,0
06037554519,037,554519,22,0,22
06037554900,037,554900,0,19,19
06037555103,037,555103,21,0,21
06037570501,037,570501,19,15,34
06037570502,037,570502,21,21,42
06037571200,037,571200,28,31,59
06037571300,037,571300,33,0,33
06037571900,037,571900,20,45,65
06037572302,037,572302,30,19,49
06037572500,037,572500,37,39,76
06037573403,037,573403,23,0,23
06037574300,037,574300,68,0,68
06037575101,037,575101,17,0,17
06037575803,037,575803,22,35,57
06037291220,037,291220,31,6,37
06037294410,037,294410,33,9,42
06037296210,037,296210,0,48,48
06037134103,037,134103,70,0,70
06037432902,037,432902,11,0,11
06037433602,037,433602,9,11,20
06037920108,037,920108,86,9,95
06037920112,037,920112,28,0,28
06037920326,037,920326,59,0,59
06037101300,037,101300,12,0,12
06037480500,037,480500,23,0,23
06037481101,037,481101,17,24,41
06037481401,037,481401,0,0,0
06037481902,037,481902,0,0,0
06037208401,037,208401,25,0,25
06037208402,037,208402,19,0,19
06037208501,037,208501,16,0,16
06037208502,037,208502,12,0,12
06037208801,037,208801,0,20,20
06071012300,071,012300,0,0,0
06071012400,071,012400,0,0,0
06071012500,071,012500,12,57,69
06071012700,071,012700,7,0,7
06071025000,071,025000,34,160,194
06071025100,071,025100,0,6,6
06071980100,071,980100,0,0,0
06071980200,071,980200,0,0,0
06073000202,073,000202,23,0,23
06073002712,073,002712,62,0,62
06073003305,073,003305,6,6,12
06085510801,085,510801,0,0,0
06085510803,085,510803,9,0,9
06085511500,085,511500,33,0,33
06085503703,085,503703,6,0,6
06085503708,085,503708,34,9,43
06085504002,085,504002,44,10,54
06085502601,085,502601,0,0,0
06085502907,085,502907,18,0,18
06085503208,085,503208,25,0,25
06085503315,085,503315,14,15,29
06085505800,085,505800,21,0,21
06037103300,037,103300,21,16,37
06037104401,037,104401,5,6,11
06037104500,037,104500,0,30,30
06037107020,037,107020,0,0,0
06085512033,085,512033,98,51,149
06085512035,085,512035,25,0,25
06037102104,037,102104,75,0,75
06037102107,037,102107,4,32,36
06037101122,037,101122,0,0,0
06037102105,037,102105,6,0,6
06037102103,037,102103,9,19,28
06037104124,037,104124,10,0,10
06037104108,037,104108,0,27,27
06037104203,037,104203,30,0,30
06073019107,073,019107,23,1,24
06073020020,073,020020,90,22,112
06073007200,073,007200,19,0,19
06073015302,073,015302,0,0,0
06073016401,073,016401,14,5,19
06073016613,073,016613,17,0,17
06059110111,059,110111,21,17,38
06059110113,059,110113,0,0,0
06059110605,059,110605,39,0,39
06059052416,059,052416,23,23,46
06059052426,059,052426,225,18,243
06059062632,059,062632,0,0,0
06059042206,059,042206,19,0,19
06059052522,059,052522,18,0,18
06059063009,059,063009,8,6,14
06059063907,059,063907,27,13,40
06059074601,059,074601,30,10,40
06059001707,059,001707,34,0,34
06001420100,001,420100,6,0,6
06001422900,001,422900,23,0,23
06001436800,001,436800,7,0,7
06001436401,001,436401,102,0,102
06001410400,001,410400,23,6,29
06059089001,059,089001,9,24,33
06059075702,059,075702,32,0,32
06059086801,059,086801,50,24,74
06059087602,059,087602,73,25,98
06059088601,059,088601,14,25,39
06059099238,059,099238,14,0,14
06059099310,059,099310,22,4,26
06059110106,059,110106,0,14,14
06059062628,059,062628,18,0,18
06037401901,037,401901,0,0,0
06037402801,037,402801,0,14,14
06037403304,037,403304,0,0,0
06037403316,037,403316,35,0,35
06037403320,037,403320,30,0,30
06037403404,037,403404,0,0,0
06037403406,037,403406,0,0,0
06037403801,037,403801,18,0,18
06037650001,037,650001,0,42,42
06037650501,037,650501,14,0,14
06037651102,037,651102,35,0,35
06037300702,037,300702,15,0,15
06037300902,037,300902,21,0,21
06037403902,037,403902,43,0,43
06037404301,037,404301,0,33,33
06037404803,037,404803,7,9,16
06037404903,037,404903,0,0,0
06037190520,037,190520,35,0,35
06037190901,037,190901,44,0,44
06037191203,037,191203,0,25,25
06037191610,037,191610,0,0,0
06037191810,037,191810,18,0,18
06073017051,073,017051,17,0,17
06073017053,073,017053,14,0,14
06073017054,073,017054,23,0,23
06073017052,073,017052,46,0,46
06073017055,073,017055,79,0,79
06073017109,073,017109,0,0,0
06073017110,073,017110,49,0,49
06037301300,037,301300,5,0,5
06037123303,037,123303,0,0,0
06037123420,037,123420,3,36,39
06037127300,037,127300,37,51,88
06037127520,037,127520,66,44,110
06037128303,037,128303,0,0,0
06037131100,037,131100,7,0,7
06037407602,037,407602,5,10,15
06037407801,037,407801,17,0,17
06037407802,037,407802,11,15,26
06037408003,037,408003,57,8,65
06037408004,037,408004,0,7,7
06037408005,037,408005,0,0,0
06037408006,037,408006,0,22,22
06037408136,037,408136,19,0,19
06073017813,073,017813,0,0,0
06073018613,073,018613,18,33,51
06073019808,073,019808,49,0,49
06037408137,037,408137,6,25,31
06037408138,037,408138,29,0,29
06037408139,037,408139,27,22,49
06037408140,037,408140,4,36,40
06037408141,037,408141,12,37,49
06037408504,037,408504,8,5,13
06037408505,037,408505,0,7,7
06037408630,037,408630,27,16,43
06037408631,037,408631,41,0,41
06065940500,065,940500,0,0,0
06065940600,065,940600,8,0,8
06065940700,065,940700,7,16,23
06065940800,065,940800,2,2,4
06065940900,065,940900,2,0,2
06065941000,065,941000,21,0,21
06065941100,065,941100,3,0,3
06037201120,037,201120,68,24,92
06037201200,037,201200,25,12,37
06037201501,037,201501,25,47,72
06037201700,037,201700,0,36,36
06037203300,037,203300,6,0,6
06037206020,037,206020,0,4,4
06037208610,037,208610,9,22,31
06037208620,037,208620,9,19,28
06037209102,037,209102,0,0,0
06037211701,037,211701,43,0,43
06037135201,037,135201,3,0,3
06037137000,037,137000,30,15,45
06037137501,037,137501,8,0,8
06037651002,037,651002,25,13,38
06037651201,037,651201,29,0,29
06037651221,037,651221,17,0,17
06037670403,037,670403,0,0,0
06037670413,037,670413,32,0,32
06037670701,037,670701,48,0,48
06037700300,037,700300,41,0,41
06037701501,037,701501,91,0,91
06037701701,037,701701,19,0,19
06037702201,037,702201,0,0,0
06059063103,059,063103,12,0,12
06059063701,059,063701,11,38,49
06037702700,037,702700,0,14,14
06037702801,037,702801,10,30,40
06037703001,037,703001,62,0,62
06037900504,037,900504,26,0,26
06037900602,037,900602,16,7,23
06037900703,037,900703,3,0,3
06037910201,037,910201,36,0,36
06037213202,037,213202,17,0,17
06037214100,037,214100,0,0,0
06037217100,037,217100,10,48,58
06037920044,037,920044,54,5,59
06037920045,037,920045,7,9,16
06037920114,037,920114,19,0,19
06037920102,037,920102,57,0,57
06037920115,037,920115,0,0,0
06037920116,037,920116,62,12,74
06037920118,037,920118,77,0,77
06037920119,037,920119,7,0,7
06037920336,037,920336,42,27,69
06037920337,037,920337,35,26,61
06037920338,037,920338,57,0,57
06037920339,037,920339,22,18,40
06037930101,037,930101,0,0,0
06037930301,037,930301,0,0,0
06037980001,037,980001,0,0,0
06037980002,037,980002,0,0,0
06037980003,037,980003,0,0,0
06037980004,037,980004,0,0,0
06037980008,037,980008,6,0,6
06037980005,037,980005,0,0,0
06037980006,037,980006,0,0,0
06037980007,037,980007,0,0,0
06037980009,037,980009,0,0,0
06037980024,037,980024,12,0,12
06037980010,037,980010,0,0,0
06059042319,059,042319,32,0,32
06059042324,059,042324,18,0,18
06059042326,059,042326,0,0,0
06059042329,059,042329,0,0,0
06059042330,059,042330,31,47,78
06059042335,059,042335,75,0,75
06059042336,059,042336,67,0,67
06059042337,059,042337,18,0,18
06037530102,037,530102,15,36,51
06037104610,037,104610,14,0,14
06037106510,037,106510,20,29,49
06037106641,037,106641,11,0,11
06037113213,037,113213,65,0,65
06037113233,037,113233,50,21,71
06037113303,037,113303,25,9,34
06037115302,037,115302,22,8,30
06037117302,037,117302,14,0,14
06037121900,037,121900,15,3,18
06037900606,037,900606,0,0,0
06037900803,037,900803,13,46,59
06037901101,037,901101,19,7,26
06037910202,037,910202,32,0,32
06037910404,037,910404,5,11,16
06037910601,037,910601,23,29,52
06037910808,037,910808,0,9,9
06037920013,037,920013,7,12,19
06037920016,037,920016,31,8,39
06037463300,037,463300,11,0,11
06037430802,037,430802,46,0,46
06037431900,037,431900,22,0,22
06037460700,037,460700,14,0,14
06037462100,037,462100,13,21,34
06037462400,037,462400,0,0,0
06037203100,037,203100,40,9,49
06037203500,037,203500,6,0,6
06037203720,037,203720,0,0,0
06037204200,037,204200,22,10,32
06037204300,037,204300,33,15,48
06037209300,037,209300,0,27,27
06037209820,037,209820,9,5,14
06037403323,037,403323,42,10,52
06037403401,037,403401,20,0,20
06037404000,037,404000,27,0,27
06059063903,059,063903,0,7,7
06059063905,059,063905,42,26,68
06059074004,059,074004,0,0,0
06059074502,059,074502,15,33,48
06059075002,059,075002,37,0,37
06059075201,059,075201,54,20,74
06059075302,059,075302,37,20,57
06059076103,059,076103,32,107,139
06059076206,059,076206,6,0,6
06059001402,059,001402,57,6,63
06059001404,059,001404,25,0,25
06059001602,059,001602,38,0,38
06059001801,059,001801,18,54,72
06059001902,059,001902,12,0,12
06059011401,059,011401,5,0,5
06065041912,065,041912,57,11,68
06065041913,065,041913,28,0,28
06065042012,065,042012,42,19,61
06065042014,065,042014,46,86,132
06065042013,065,042013,9,0,9
06065042217,065,042217,9,10,19
06073021900,073,021900,39,16,55
06073022000,073,022000,0,37,37
06073022100,073,022100,76,33,109
06073990100,073,990100,0,0,0
06037143901,037,143901,37,0,37
06037183220,037,183220,0,0,0
06037185100,037,185100,34,0,34
06037185320,037,185320,0,8,8
06037186100,037,186100,13,0,13
06037261101,037,261101,24,0,24
06037243000,037,243000,67,0,67
06037262100,037,262100,15,0,15
06037262303,037,262303,32,0,32
06037262601,037,262601,13,0,13
06037400900,037,400900,38,0,38
06037401102,037,401102,0,0,0
06037401312,037,401312,9,0,9
06037402200,037,402200,43,14,57
06037408723,037,408723,13,5,18
06059021823,059,021823,23,0,23
06059021824,059,021824,20,0,20
06059021914,059,021914,60,4,64
06059032028,059,032028,17,0,17
06059032033,059,032033,30,0,30
06059032043,059,032043,10,9,19
06059042103,059,042103,20,11,31
06059042113,059,042113,6,9,15
06037209510,037,209510,0,0,0
06037212304,037,212304,0,3,3
06037530602,037,530602,27,0,27
06037532605,037,532605,0,30,30
06037535502,037,535502,0,15,15
06037540600,037,540600,0,48,48
06037543802,037,543802,60,14,74
06037551900,037,551900,31,0,31
06037554001,037,554001,0,0,0
06037602003,037,602003,28,0,28
06037553902,037,553902,21,0,21
06037910402,037,910402,14,18,32
06037920331,037,920331,9,30,39
06037138000,037,138000,36,0,36
06037181600,037,181600,15,0,15
06037187200,037,187200,16,0,16
06037191420,037,191420,3,0,3
06037195500,037,195500,24,0,24
06037408212,037,408212,33,0,33
06037139503,037,139503,32,0,32
06037139504,037,139504,7,8,15
06037408724,037,408724,60,0,60
06037430003,037,430003,90,0,90
06037430901,037,430901,49,26,75
06037430902,037,430902,10,0,10
06037431501,037,431501,10,0,10
06037431502,037,431502,18,0,18
06037433102,037,433102,27,12,39
06037433304,037,433304,0,0,0
06037433305,037,433305,0,39,39
06037433101,037,433101,3,0,3
06037433306,037,433306,9,27,36
06037433307,037,433307,6,30,36
06037433503,037,433503,0,0,0
06037433504,037,433504,7,9,16
06037434003,037,434003,0,16,16
06067002500,067,002500,6,0,6
06067003600,067,003600,14,7,21
06067004004,067,004004,14,0,14
06067004008,067,004008,28,0,28
06067004009,067,004009,0,0,0
06067005101,067,005101,22,32,54
06067005404,067,005404,0,0,0
06067007601,067,007601,10,63,73
06067006400,067,006400,0,31,31
06067006600,067,006600,0,45,45
06067007417,067,007417,18,1,19
06067008007,067,008007,12,18,30
06067008009,067,008009,32,21,53
06067008120,067,008120,17,0,17
06067008127,067,008127,67,0,67
06067008132,067,008132,65,0,65
06067008145,067,008145,70,0,70
06037236400,037,236400,23,0,23
06037237720,037,237720,0,17,17
06037240500,037,240500,36,33,69
06037240900,037,240900,25,33,58
06037261102,037,261102,24,0,24
06037262200,037,262200,5,0,5
06037262301,037,262301,11,0,11
06037262400,037,262400,32,0,32
06037265100,037,265100,0,0,0
06037265301,037,265301,0,0,0
06037530700,037,530700,7,0,7
06037531301,037,531301,0,26,26
06037531502,037,531502,7,21,28
06037103102,037,103102,61,0,61
06037218300,037,218300,0,71,71
06037218400,037,218400,28,13,41
06037219700,037,219700,0,31,31
06037220000,037,220000,17,0,17
06067008008,067,008008,8,19,27
06067008010,067,008010,0,0,0
06067007004,067,007004,22,131,153
06067007007,067,007007,42,0,42
06067008402,067,008402,104,0,104
06067008122,067,008122,0,13,13
06067008140,067,008140,37,33,70
06067008209,067,008209,0,0,0
06067009111,067,009111,10,49,59
06067009308,067,009308,11,23,34
06037555202,037,555202,0,0,0
06037555211,037,555211,47,40,87
06037555212,037,555212,0,28,28
06037570800,037,570800,39,0,39
06037407002,037,407002,23,12,35
06059086701,059,086701,103,25,128
06059086803,059,086803,0,15,15
06059086901,059,086901,17,26,43
06059087101,059,087101,0,6,6
06059088201,059,088201,27,0,27
06059099513,059,099513,0,0,0
06059110010,059,110010,33,0,33
06059110603,059,110603,0,59,59
06059110604,059,110604,29,0,29
06059021815,059,021815,67,0,67
06059021821,059,021821,90,105,195
06059021826,059,021826,57,0,57
06059021829,059,021829,61,0,61
06059021917,059,021917,0,0,0
06059021924,059,021924,0,0,0
06059032011,059,032011,0,0,0
06059032013,059,032013,35,0,35
06059032015,059,032015,57,0,57
06059032042,059,032042,9,0,9
06059032047,059,032047,53,0,53
06059042201,059,042201,33,35,68
06059042310,059,042310,25,0,25
06059042311,059,042311,90,0,90
06059042315,059,042315,23,0,23
06059042327,059,042327,20,0,20
06059042338,059,042338,17,0,17
06059052427,059,052427,73,0,73
06059052521,059,052521,0,0,0
06059052523,059,052523,8,0,8
06059052525,059,052525,167,54,221
06001450602,001,450602,88,0,88
06059032045,059,032045,8,0,8
06059032046,059,032046,12,0,12
06059032048,059,032048,8,0,8
06059032053,059,032053,69,0,69
06059042108,059,042108,68,20,88
06059042305,059,042305,10,0,10
06059042332,059,042332,0,23,23
06059052411,059,052411,0,0,0
06059052422,059,052422,120,0,120
06059052424,059,052424,8,0,8
06001443001,001,443001,18,0,18
06001450200,001,450200,24,20,44
06001427800,001,427800,53,0,53
06001428301,001,428301,31,20,51
06001433000,001,433000,9,12,21
06001433200,001,433200,94,60,154
06001435200,001,435200,10,0,10
06001436402,001,436402,24,0,24
06067988300,067,988300,0,0,0
06059110115,059,110115,0,28,28
06059110116,059,110116,0,0,0
06059110203,059,110203,48,7,55
06059110606,059,110606,33,0,33
06059001802,059,001802,81,74,155
06059011000,059,011000,19,0,19
06059011200,059,011200,0,0,0
06059011502,059,011502,23,0,23
06059011602,059,011602,12,0,12
06059011712,059,011712,23,11,34
06059011715,059,011715,81,0,81
06059011718,059,011718,40,0,40
06059021905,059,021905,0,0,0
06059032012,059,032012,15,0,15
06059032020,059,032020,59,0,59
06059032022,059,032022,65,0,65
06059032027,059,032027,92,73,165
06059001301,059,001301,52,34,86
06059001304,059,001304,13,10,23
06037403312,037,403312,30,17,47
06037238000,037,238000,0,0,0
06037238320,037,238320,33,35,68
06085508202,085,508202,34,15,49
06085509108,085,509108,70,0,70
06085509109,085,509109,66,7,73
06085509404,085,509404,114,65,179
06085509500,085,509500,16,0,16
06037238400,037,238400,7,0,7
06037242600,037,242600,0,46,46
06037243100,037,243100,31,61,92
06037264302,037,264302,25,0,25
06037403317,037,403317,20,0,20
06037403318,037,403318,51,0,51
06085501402,085,501402,24,25,49
06085502301,085,502301,30,18,48
06085501101,085,501101,31,30,61
06085501102,085,501102,26,22,48
06085501401,085,501401,16,2,18
06085502302,085,502302,43,0,43
06085502604,085,502604,30,0,30
06085503117,085,503117,22,0,22
06085503118,085,503118,27,35,62
06085503121,085,503121,26,11,37
06085503122,085,503122,30,0,30
06085502603,085,502603,25,0,25
06085503123,085,503123,9,0,9
06037265305,037,265305,0,0,0
06037265420,037,265420,0,0,0
06037267100,037,267100,106,0,106
06037267800,037,267800,0,0,0
06037269000,037,269000,12,0,12
06037269300,037,269300,30,0,30
06037269500,037,269500,60,0,60
06037269800,037,269800,0,0,0
06037271802,037,271802,64,14,78
06037273200,037,273200,11,11,22
06037275200,037,275200,45,0,45
06037293304,037,293304,0,22,22
06037264301,037,264301,0,0,0
06037540901,037,540901,0,21,21
06037541200,037,541200,25,55,80
06037541605,037,541605,19,0,19
06037541606,037,541606,0,7,7
06001409100,001,409100,14,0,14
06001409400,001,409400,19,30,49
06001410300,001,410300,23,0,23
06001420300,001,420300,0,0,0
06001423200,001,423200,0,13,13
06001423300,001,423300,21,29,50
06001423601,001,423601,12,0,12
06001427700,001,427700,0,0,0
06037271400,037,271400,0,16,16
06037271701,037,271701,27,0,27
06037271801,037,271801,0,0,0
06037273800,037,273800,0,0,0
06037276400,037,276400,8,0,8
06037276500,037,276500,0,0,0
06037277100,037,277100,28,0,28
06037293201,037,293201,19,83,102
06073003101,073,003101,0,29,29
06073003111,073,003111,31,32,63
06073003114,073,003114,15,11,26
06073003212,073,003212,0,15,15
06073003303,073,003303,13,13,26
06073003902,073,003902,0,0,0
06073005300,073,005300,5,0,5
06073005400,073,005400,24,0,24
06067007427,067,007427,35,53,88
06067007428,067,007428,0,0,0
06067007429,067,007429,0,30,30
06067007430,067,007430,99,37,136
06067007301,067,007301,0,20,20
06067007431,067,007431,8,0,8
06067007432,067,007432,8,0,8
06067007433,067,007433,33,0,33
06067008505,067,008505,5,0,5
06067008506,067,008506,18,0,18
06067008507,067,008507,61,18,79
06067008508,067,008508,21,0,21
06067008509,067,008509,17,0,17
06085512052,085,512052,33,12,45
06085512053,085,512053,23,19,42
06085512311,085,512311,27,0,27
06085512312,085,512312,40,25,65
06085512310,085,512310,12,0,12
06085512314,085,512314,7,7,14
06085512313,085,512313,58,11,69
06073016502,073,016502,18,10,28
06073002702,073,002702,51,17,68
06073001000,073,001000,0,0,0
06073001300,073,001300,17,34,51
06073001500,073,001500,13,0,13
06073002703,073,002703,17,50,67
06073002903,073,002903,24,0,24
06073003108,073,003108,28,6,34
06073003207,073,003207,0,0,0
06073003214,073,003214,82,8,90
06073003403,073,003403,0,69,69
06073003603,073,003603,25,12,37
06073004000,073,004000,0,22,22
06073004900,073,004900,85,0,85
06073005500,073,005500,12,0,12
06073006300,073,006300,0,0,0
06073006802,073,006802,31,3,34
06073006900,073,006900,27,0,27
06073007301,073,007301,0,0,0
06073007400,073,007400,118,0,118
06073007501,073,007501,1,0,1
06073020306,073,020306,71,18,89
06073020403,073,020403,60,64,124
06073020405,073,020405,17,0,17
06073020602,073,020602,42,27,69
06073020705,073,020705,14,0,14
06073020708,073,020708,65,0,65
06073020805,073,020805,0,0,0
06073020809,073,020809,51,0,51
06073020903,073,020903,22,2,24
06073021000,073,021000,0,0,0
06073013102,073,013102,48,0,48
06073013205,073,013205,40,4,44
06073013302,073,013302,0,22,22
06073013604,073,013604,0,0,0
06073013605,073,013605,20,0,20
06037403324,037,403324,15,0,15
06037403405,037,403405,0,0,0
06037403703,037,403703,43,0,43
06037404501,037,404501,0,0,0
06037405201,037,405201,0,0,0
06037405202,037,405202,35,6,41
06037406101,037,406101,36,0,36
06037407200,037,407200,0,15,15
06037408202,037,408202,0,0,0
06037408706,037,408706,23,0,23
06037430301,037,430301,7,0,7
06037430302,037,430302,0,0,0
06037432000,037,432000,0,0,0
06037432101,037,432101,9,0,9
06037432102,037,432102,11,4,15
06037432201,037,432201,0,0,0
06037433401,037,433401,8,18,26
06037433403,037,433403,0,23,23
06037433700,037,433700,9,0,9
06037433801,037,433801,20,17,37
06037433901,037,433901,17,59,76
06037461400,037,461400,10,0,10
06037463400,037,463400,21,0,21
06037480202,037,480202,33,0,33
06037480400,037,480400,9,0,9
06037127910,037,127910,53,23,76
06037127920,037,127920,15,0,15
06037572400,037,572400,13,6,19
06037572800,037,572800,0,6,6
06037573201,037,573201,17,10,27
06037573300,037,573300,8,40,48
06037218210,037,218210,24,0,24
06037218600,037,218600,0,9,9
06037218900,037,218900,0,10,10
06037219300,037,219300,31,22,53
06085511302,085,511302,32,0,32
06085511704,085,511704,0,0,0
06085511608,085,511608,0,0,0
06085511609,085,511609,47,0,47
06085511705,085,511705,4,0,4
06085511707,085,511707,8,0,8
06085511915,085,511915,14,0,14
06085511916,085,511916,0,25,25
06071009906,071,009906,0,0,0
06071009908,071,009908,14,52,66
06071009910,071,009910,67,0,67
06071009911,071,009911,14,0,14
06071009912,071,009912,14,10,24
06071009913,071,009913,24,8,32
06071010025,071,010025,0,42,42
06071010026,071,010026,119,0,119
06059075701,059,075701,50,74,124
06059075811,059,075811,8,0,8
06059075901,059,075901,7,0,7
06059076202,059,076202,67,16,83
06059086404,059,086404,36,33,69
06059086405,059,086405,26,0,26
06059086601,059,086601,0,0,0
06059087704,059,087704,59,0,59
06059087806,059,087806,48,0,48
06059088107,059,088107,15,13,28
06065042901,065,042901,24,39,63
06065042902,065,042902,23,0,23
06065043216,065,043216,0,0,0
06065031002,065,031002,22,0,22
06065041411,065,041411,0,0,0
06065041702,065,041702,45,0,45
06065042508,065,042508,0,8,8
06065043703,065,043703,11,0,11
06065041803,065,041803,0,0,0
06065042405,065,042405,16,58,74
06065043304,065,043304,27,0,27
06065042003,065,042003,48,19,67
06071010417,071,010417,0,0,0
06071010419,071,010419,0,0,0
06071010420,071,010420,27,0,27
06071010421,071,010421,17,0,17
06071010422,071,010422,0,0,0
06071010423,071,010423,17,0,17
06071010424,071,010424,0,0,0
06071010803,071,010803,0,0,0
06071010804,071,010804,0,0,0
06071010901,071,010901,19,34,53
06071010902,071,010902,9,0,9
06071011001,071,011001,0,0,0
06071011002,071,011002,0,0,0
06037271600,037,271600,15,19,34
06037463000,037,463000,31,0,31
06037293302,037,293302,32,55,87
06037460502,037,460502,55,0,55
06037195710,037,195710,0,0,0
06037139502,037,139502,32,0,32
06037143300,037,143300,0,0,0
06037211910,037,211910,0,0,0
06037213201,037,213201,0,52,52
06037800324,037,800324,31,0,31
06037800326,037,800326,20,0,20
06037701801,037,701801,30,0,30
06037702600,037,702600,12,10,22
06037703200,037,703200,78,20,98
06037800325,037,800325,13,0,13
06037900102,037,900102,0,0,0
06037900501,037,900501,19,12,31
06037901205,037,901205,33,68,101
06037910602,037,910602,22,0,22
06037920314,037,920314,0,7,7
06037920036,037,920036,9,0,9
06065042711,065,042711,20,0,20
06065043702,065,043702,0,46,46
06065031502,065,031502,26,77,103
06065040902,065,040902,0,33,33
06059021809,059,021809,7,5,12
06059021812,059,021812,11,0,11
06059021820,059,021820,21,0,21
06059021822,059,021822,33,0,33
06059021828,059,021828,20,0,20
06059021919,059,021919,19,0,19
06059021922,059,021922,83,0,83
06059021923,059,021923,38,0,38
06059032023,059,032023,33,28,61
06059032055,059,032055,37,0,37
06059099215,059,099215,62,0,62
06059099226,059,099226,0,0,0
06059099231,059,099231,0,0,0
06059099241,059,099241,11,0,11
06037222600,037,222600,0,9,9
06037533803,037,533803,43,18,61
06037534101,037,534101,0,0,0
06037219010,037,219010,0,0,0
06037219020,037,219020,0,9,9
06037231400,037,231400,22,71,93
06037234700,037,234700,15,0,15
06037235202,037,235202,13,35,48
06037237600,037,237600,0,10,10
06037237800,037,237800,15,16,31
06037239310,037,239310,4,3,7
06037239320,037,239320,24,58,82
06037240300,037,240300,0,64,64
06037240800,037,240800,5,50,55
06037123104,037,123104,38,23,61
06037124600,037,124600,0,0,0
06037127102,037,127102,0,53,53
06037128302,037,128302,0,17,17
06037128702,037,128702,0,0,0
06037503202,037,503202,9,0,9
06037503501,037,503501,5,0,5
06037503502,037,503502,0,0,0
06037504102,037,504102,0,0,0
06037265700,037,265700,17,50,67
06037267300,037,267300,110,0,110
06067009006,067,009006,12,60,72
06067009112,067,009112,53,0,53
06067009319,067,009319,32,14,46
06067009320,067,009320,62,7,69
06067009321,067,009321,29,11,40
06067009322,067,009322,106,106,212
06067009617,067,009617,52,0,52
06067009618,067,009618,44,23,67
06067009619,067,009619,33,44,77
06067006800,067,006800,19,27,46
06067005601,067,005601,0,35,35
06067005606,067,005606,25,0,25
06067006004,067,006004,11,0,11
06067007010,067,007010,9,0,9
06073020015,073,020015,31,0,31
06073020024,073,020024,46,15,61
06073020106,073,020106,0,0,0
06073020206,073,020206,34,20,54
06073020209,073,020209,0,0,0
06037104204,037,104204,4,11,15
06037104403,037,104403,21,0,21
06037104404,037,104404,0,5,5
06037104703,037,104703,0,0,0
06037104704,037,104704,25,72,97
06037104821,037,104821,0,0,0
06037104822,037,104822,0,0,0
06037106405,037,106405,0,0,0
06037106406,037,106406,33,16,49
06037800331,037,800331,16,0,16
06037800332,037,800332,0,0,0
06037800406,037,800406,8,0,8
06037800408,037,800408,15,0,15
06037800410,037,800410,13,0,13
06071002038,071,002038,0,0,0
06071002103,071,002103,37,99,136
06071002105,071,002105,50,21,71
06071002107,071,002107,0,21,21
06071002109,071,002109,12,19,31
06071002110,071,002110,139,0,139
06071002206,071,002206,53,66,119
06071002207,071,002207,15,0,15
06071002304,071,002304,90,0,90
06071002305,071,002305,45,0,45
06071002306,071,002306,14,1,15
06071002307,071,002307,12,12,24
06071002604,071,002604,7,37,44
06071002606,071,002606,24,12,36
06071002607,071,002607,12,17,29
06071002703,071,002703,0,0,0
06071002704,071,002704,18,0,18
06071002705,071,002705,49,0,49
06071002706,071,002706,63,37,100
06071002801,071,002801,17,74,91
06071003301,071,003301,5,0,5
06071002803,071,002803,13,16,29
06001424001,001,424001,21,0,21
06001432700,001,432700,0,10,10
06085509403,085,509403,56,0,56
06085509802,085,509802,22,0,22
06085510200,085,510200,52,0,52
06085510600,085,510600,50,0,50
06085511800,085,511800,0,0,0
06085511907,085,511907,23,0,23
06085511909,085,511909,0,0,0
06085512021,085,512021,25,4,29
06085512026,085,512026,42,0,42
06085503802,085,503802,40,0,40
06085503803,085,503803,17,54,71
06085503804,085,503804,32,12,44
06085504307,085,504307,25,0,25
06085504311,085,504311,113,0,113
06085504413,085,504413,17,0,17
06085504420,085,504420,0,0,0
06085505007,085,505007,26,13,39
06085505402,085,505402,11,9,20
06085506204,085,506204,0,0,0
06085506305,085,506305,42,0,42
06085506402,085,506402,27,0,27
06085506703,085,506703,20,14,34
